reihe_+n_folge	reihenfolge
internet_seite	internetseite
arbeit_+s_gemeinschaft	arbeitsgemeinschaft
öffnung_+s_zeit	öffnungszeit
welt_krieg	weltkrieg
rahmen_bedingung	rahmenbedingung
fach_bereich	fachbereich
mittel_punkt	mittelpunkt
stadt_rat	stadtrat
strafe_-e_tat	straftat
band_breite	bandbreite
kirche_+n_gemeinde	kirchengemeinde
spiel_tag	spieltag
mittag_essen	mittagessen
arbeit_+s_verhältnis	arbeitsverhältnis
schule_-e_jahr	schuljahr
leistung_+s_fähigkeit	leistungsfähigkeit
abend_essen	abendessen
bund_+es_verband	bundesverband
sicht_weise	sichtweise
