tor_schütze	tor_+s_che_-e_ütze
zahn_bürste	za_hnbür_+s_te
kamera_mann	ka_m_er_ae_-e_me_-e_ann
dampf_lok	d_a_mpfloe_-e_k
berg_welt	berge_-e_we_-e_el_t
preis_gestaltung	pre_i_+s_ge_+s_tae_-e_lte_-e_u_+n_g
welt_friede	wel_te_-e_fe_-e_re_-e_iede
kunde_-e_gebung	ku_+n_de_-e_gebe_-e_une_-e_g
einsatz_bereitschaft	ei_+n_sae_-e_te_-e_ze_-e_beree_-e_it_+s_chafe_-e_t
geld_automat	ge_ldautomae_-e_t
zahn_ersatz	za_hner_+s_ate_-e_z
studio_album	s_t_udie_-e_oalbue_-e_m
rücken_lehne	rü_ce_-e_k_+en_lehne
einsatz_stelle	ei_+n_sate_-e_z_+s_tele_-e_le
aufbruch_stimmung	a_u_fe_-e_bruch_+s_te_-e_ie_-e_m_mu_+n_g
paar_kreuz	paare_-e_kreue_-e_z
zahlung_+s_mittel	zah_lu_+n_g_+s_mittee_-e_l
maß_einheit	maß_ee_-e_i_+n_heie_-e_t
meer_wasser	meere_-e_wa_+s_ser
probe_fahrt	pr_o_be_fahre_-e_t
mitglied_+s_unternehmen	mite_-e_ge_-e_l_ied_+s_u_+n_ternehe_-e_me_-e_en
herz_krankheit	herze_-e_kra_+n_ke_-e_heie_-e_t
schwierigkeit_+s_grad	sc_he_-e_wierie_-e_ge_-e_ke_-e_ei_t_+s_grad
kirche_+n_steuer	kirc_h_+ens_tee_-e_uer
verein_+s_mitglied	veree_-e_i_+ns_me_-e_ie_-e_tglied
vogel_grippe	vogelgri_pe_-e_pe_-e_e
urlaub_+s_ort	ur_laub_+s_ore_-e_t
verkehr_+s_politik	ver_kehr_+s_pe_-e_olitie_-e_k
auge_+n_weide	a_u_g_+en_wee_-e_i_de
bauch_raum	ba_uchraue_-e_m
stadt_führung	st_adte_-e_fe_-e_ührune_-e_g
kultusminister_konferenz	kul_tu_+s_m_i_+n_i_+s_tere_-e_ke_-e_o_+n_fer_+en_z
schach_freund	sc_hache_-e_freund
nahrung_+s_ergänzung	n_a_hru_+n_g_+s_erge_-e_ä_+n_z_une_-e_g
werbung_+s_kosten	wer_bu_+n_g_+s_k_o_+s_ten
test_spiel	t_+es_t_+s_p_iee_-e_l
führer_schein	fü_hrer_+s_ce_-e_heie_-e_n
schule_-e_kind	sc_he_-e_ule_-e_ki_+n_d
auto_minute	au_te_-e_o_mi_+n_ute
partner_stadt	par_tner_+s_te_-e_ade_-e_t
jugend_bereich	jug_+en_dberee_-e_ich
text_passage	te_x_te_-e_pa_+s_sage
bauer_+n_haus	ba_uernhaue_-e_s
kündigung_+s_frist	kü_+n_d_ige_-e_u_+n_g_+s_fre_-e_i_+s_t
strom_erzeugung	st_re_-e_o_me_-e_er_zeu_ge_-e_une_-e_g
blut_gefäß	bl_utgefe_-e_äe_-e_ß
gemeinderat_+s_sitzung	g_e_me_-e_ee_-e_i_+n_derat_+s_se_-e_ite_-e_ze_-e_une_-e_g
presse_meldung	pr_+es_see_-e_mee_-e_ldune_-e_g
verkehr_+s_anbindung	ver_keh_r_+s_ane_-e_be_-e_inde_-e_une_-e_g
erfahrung_+s_schatz	e_r_fahru_+n_g_+s_schate_-e_z
ausbildung_+s_stätte	au_+s_be_-e_ie_-e_ldu_+n_g_+s_ste_-e_ätte
schwelle_+n_wert	sc_he_-e_we_-e_el_l_+en_we_-e_ere_-e_t
frau_+en_kirche	fra_u_+en_kirche
gedanke_+n_austausch	geda_+n_k_+en_au_+s_tae_-e_u_+s_ce_-e_h
start_loch	st_artle_-e_och
wohnung_+s_unternehmen	woh_+n_u_+n_g_+s_u_+n_ternehe_-e_me_-e_en
qualität_+s_merkmal	qua_le_-e_ite_-e_äe_-e_t_+s_me_-e_er_ke_-e_mae_-e_l
umwelt_minister	u_m_wel_te_-e_m_i_+n_i_+s_ter
auge_+n_lid	a_u_g_+en_le_-e_id
kalender_jahr	ka_l_+en_dere_-e_je_-e_ah_r
strom_kreis	st_re_-e_o_mkreie_-e_s
ansicht_+s_sache	a_+n_se_-e_ie_-e_che_-e_t_+s_sache
regen_schirm	r_e_g_+en_sche_-e_ire_-e_m
lösung_+s_vorschlag	lö_+s_u_+n_g_+s_v_or_+s_che_-e_lae_-e_g
stadt_halle	st_adthale_-e_le
film_vorführung	file_-e_m_vorf_üe_-e_hrune_-e_g
bewegung_+s_freiheit	b_e_we_-e_eg_u_+n_g_+s_fre_ie_-e_heie_-e_t
höhe_+n_meter	hö_h_+en_mee_-e_ter
europa_parlament	eu_re_-e_oe_-e_pe_-e_ap_ar_lae_-e_m_+en_t
maul_korb	maule_-e_kore_-e_b
version_+s_nummer	ver_+s_ie_-e_o_+n_s_+n_ue_-e_me_-e_mer
not_situation	n_o_t_+s_ite_-e_uatie_-e_oe_-e_n
verfassung_+s_beschwerde	ver_fa_+s_se_-e_u_+n_g_+s_b_+es_che_-e_werde
haupt_attraktion	ha_ue_-e_pe_-e_tate_-e_trae_-e_ke_-e_tie_-e_oe_-e_n
konzert_haus	ko_+n_zerte_-e_haue_-e_s
grund_besitz	gr_undbe_+s_ie_-e_te_-e_z
termin_kalender	ter_me_-e_i_+n_k_ae_-e_l_+en_der
preis_vergleich	prei_+s_ver_ge_-e_lee_-e_ich
bau_form	baufe_-e_ore_-e_m
geburt_+s_stunde	ge_bure_-e_t_+s_ste_-e_u_+n_de
weg_fall	weg_fale_-e_l
arbeit_+s_schritt	ar_bee_-e_i_t_+s_schrie_-e_te_-e_t
auto_bauer	au_te_-e_obauer
bildung_+s_angebot	b_i_ldu_+n_g_+s_a_+n_gebe_-e_oe_-e_t
sommer_reifen	s_o_me_-e_mer_ree_-e_ie_-e_fen
renovierung_+s_arbeit	r_+en_oe_-e_viere_-e_u_+n_g_+s_arbeie_-e_t
nord_seite	no_rd_+s_eie_-e_te
berg_bau	berge_-e_bae_-e_u
flug_gast	fl_ugge_-e_a_+s_t
gespräch_+s_partner	g_+es_pe_-e_re_-e_ä_ch_+s_pe_-e_ar_t_+n_er
spiel_klasse	s_p_iel_ke_-e_la_+s_se
rettung_+s_wagen	re_tte_-e_u_+n_g_+s_wae_-e_gen
post_moderne	po_+s_t_me_-e_oderne
bund_+es_polizei	bu_+n_de_+s_pe_-e_oe_-e_lizee_-e_i
art_genosse	ar_te_-e_g_+en_o_+s_se
gas_preis	ga_+s_preie_-e_s
mutter_leib	mut_tere_-e_leie_-e_b
haus_verwaltung	ha_u_+s_ve_-e_er_we_-e_ae_-e_l_te_-e_u_+n_g
hintergrund_musik	hi_+n_tergre_-e_unde_-e_me_-e_u_+s_ie_-e_k
personal_entwicklung	per_+s_o_+n_a_l_+en_te_-e_we_-e_ic_k_le_-e_u_+n_g
schmerz_grenze	sc_he_-e_me_-e_er_ze_-e_gr_+en_ze
partner_land	par_t_+n_ere_-e_le_-e_and
ingenieur_wissenschaft	i_+n_g_+en_ieure_-e_w_i_+s_s_+en_schafe_-e_t
risiko_management	ri_+s_ie_-e_ke_-e_oe_-e_manae_-e_gee_-e_m_+en_t
kultur_landschaft	kul_te_-e_ure_-e_land_+s_chafe_-e_t
schluss_punkt	sc_he_-e_le_-e_u_+s_se_-e_pe_-e_u_+n_ke_-e_t
ehe_partner	eh_ee_-e_pe_-e_ar_t_+n_er
bund_+es_kanzler	bu_+n_de_+s_ke_-e_anze_-e_ler
ferien_anlage	fer_i_+en_ane_-e_lage
teil_aspekt	tei_le_-e_ase_-e_pek_t
bahn_übergang	ba_h_+n_ü_bere_-e_ge_-e_ane_-e_g
stadt_meisterschaft	st_adte_-e_me_-e_ei_+s_ter_+s_chafe_-e_t
stadt_grenze	st_adte_-e_gr_+en_ze
etappe_+n_ziel	et_ae_-e_p_p_+en_ze_-e_iee_-e_l
sport_gerät	s_p_oe_-e_rt_geräe_-e_t
währung_+s_fonds	währ_u_+n_g_+s_f_o_+n_ds
kultur_raum	ku_l_turraue_-e_m
ton_studio	to_+n_s_te_-e_udie_-e_o
holz_kohl	ho_lzkohe_-e_l
natur_forscher	n_a_te_-e_ure_-e_f_or_+s_ce_-e_her
glied_maß	g_l_iede_-e_me_-e_ae_-e_ß
medizin_produkt	med_ize_-e_i_+n_pre_-e_oe_-e_due_-e_ke_-e_t
ehe_gatte	eh_egate_-e_te
fachhochschule_-e_reif	face_-e_hhe_-e_oe_-e_ch_+s_chulreie_-e_f
kunst_akademie	ku_+n_se_-e_tae_-e_kadee_-e_me_-e_ie
gebiet_+s_körperschaft	ge_biet_+s_k_öe_-e_rp_er_+s_chafe_-e_t
arbeit_+s_gruppe	ar_beit_+s_grupe_-e_pe_-e_e
gegenüber_stellung	ge_g_+en_üe_-e_ber_+s_tee_-e_l_le_-e_u_+n_g
oper_+n_haus	opernhaue_-e_s
erfolg_+s_geschichte	e_r_fe_-e_oe_-e_lg_+s_g_+es_chichte
gut_+=er_zug	gü_terzue_-e_g
schule_-e_gebäude	sc_hue_-e_le_-e_geb_äe_-e_ude
land_+es_kirche	lande_+s_kirche
maus_taste	mau_+s_ta_+s_te
kultur_einrichtung	ku_l_turee_-e_i_+n_re_-e_ichte_-e_une_-e_g
grund_ausstattung	gr_u_+n_dau_+s_se_-e_tatte_-e_une_-e_g
tasche_+n_tuch	ta_+s_ch_+en_te_-e_uce_-e_h
zahn_+=e_putz	zä_hnee_-e_pute_-e_z
kreis_sparkasse	kre_i_+s_s_pe_-e_ar_ka_+s_se
fach_kreis	fache_-e_kreie_-e_s
universität_+s_bibliothek	u_+n_i_ver_+s_ie_-e_te_-e_ät_+s_bibe_-e_le_-e_ie_-e_othee_-e_k
scheibe_+n_wischer	sc_hee_-e_i_b_+en_we_-e_i_+s_cher
gericht_+s_saal	gere_-e_ie_-e_che_-e_t_+s_saae_-e_l
geburt_+s_stadt	ge_bure_-e_t_+s_se_-e_te_-e_ade_-e_t
obdach_los	obdachle_-e_oe_-e_s
schluss_minute	sc_he_-e_le_-e_u_+s_se_-e_mi_+n_ute
kontakt_adresse	ko_+n_te_-e_ae_-e_k_te_-e_adr_+es_se
automobil_industrie	au_te_-e_oe_-e_me_-e_obe_-e_i_li_+n_du_+s_trie
veranstaltung_+s_reihe	ver_a_+ns_tae_-e_l_te_-e_u_+n_g_+s_reihe
stau_raum	st_auraue_-e_m
ort_+s_teil	ort_+s_teie_-e_l
wasser_wechsel	wa_+s_sere_-e_wec_h_+s_ee_-e_l
entwicklung_+s_zeit	en_te_-e_we_-e_ic_k_le_-e_u_+n_g_+s_zeie_-e_t
gesellschaft_+s_spiel	g_+es_ee_-e_le_-e_l_+s_ce_-e_hae_-e_fe_-e_t_+s_se_-e_pe_-e_iee_-e_l
schule_-e_system	sc_hue_-e_lse_-e_y_+s_tee_-e_m
chemo_therapie	chee_-e_m_oe_-e_therae_-e_pe_-e_ie
lunge_+n_entzündung	lu_+n_g_+en_ente_-e_ze_-e_ündune_-e_g
taste_+n_druck	ta_+s_t_+en_druce_-e_k
video_aufnahme	vide_oe_-e_au_f_+n_ahe_-e_me_-e_e
stadt_verwaltung	st_adt_ve_-e_er_we_-e_ae_-e_l_te_-e_u_+n_g
sprache_-e_ausgabe	sp_ra_chae_-e_u_+s_gabe
bauer_+n_hof	ba_uernhe_-e_oe_-e_f
frühstück_+s_buffet	fr_ü_h_+s_te_-e_üe_-e_ce_-e_k_+s_bue_-e_fe_-e_fee_-e_t
auto_biographie	au_te_-e_oe_-e_bi_ograe_-e_phie
hand_tuch	ha_ndtuce_-e_h
stau_damm	st_audame_-e_m
test_sieger	t_+es_t_+s_iee_-e_ger
wasser_werk	wa_+s_sere_-e_we_-e_ere_-e_k
unternehmen_+s_berater	u_+n_ternehe_-e_m_+ens_berae_-e_ter
tisch_tennis	ti_+s_ce_-e_he_-e_tennie_-e_s
beipack_zettel	bei_pe_-e_ac_ke_-e_zet_tee_-e_l
land_+es_recht	la_+n_d_+es_reche_-e_t
form_blatt	fo_re_-e_m_be_-e_late_-e_t
volk_+s_musik	vol_k_+s_m_u_+s_ie_-e_k
mittwoch_abend	mite_-e_te_-e_w_ochae_-e_bend
strahl_+en_belastung	st_rahe_-e_l_+en_bee_-e_le_-e_a_+s_te_-e_une_-e_g
flug_lärm	flugläre_-e_m
nacht_ruhe	na_chtruhe
tag_+es_ordnung	ta_g_+es_ordne_-e_une_-e_g
rast_stätte	ra_+s_t_+s_te_-e_ätte
not_bremse	n_o_tbree_-e_m_+s_e
literatur_preis	li_terate_-e_ure_-e_preie_-e_s
bronze_medaille	b_r_o_+n_ze_-e_ee_-e_medae_-e_ile_-e_le
durchschnitt_+s_alter	du_rch_+s_ch_+n_ie_-e_te_-e_t_+s_ae_-e_le_-e_ter
haut_arzt	ha_utarze_-e_t
strom_anbieter	st_re_-e_o_man_be_-e_iee_-e_ter
geld_strafe	ge_ld_+s_trafe
antrag_stellung	a_+n_trag_+s_tee_-e_l_le_-e_u_+n_g
erde_-e_wärme	erdwe_-e_ärm_e
lok_führer	lo_ke_-e_führer
kunde_+n_service	ku_+n_de_+ns_ere_-e_vice
vorstellung_+s_kraft	vor_+s_tee_-e_l_le_-e_u_+n_g_+s_krafe_-e_t
pflege_personal	pflegee_-e_per_+s_o_+n_ae_-e_l
irak_krieg	ira_ke_-e_krieg
wettbewerb_+s_recht	wet_te_-e_bee_-e_we_-e_er_b_+s_reche_-e_t
spiel_freude	s_p_iel_fre_ude
finanz_hilfe	fi_+n_ane_-e_zhile_-e_fe
verwaltung_+s_gebäude	ver_we_-e_ae_-e_l_te_-e_u_+n_g_+s_geb_äe_-e_ude
kopf_tuch	ko_pftuce_-e_h
alter_+s_rente	a_l_ter_+s_r_+en_te
grund_buch	gr_undbuch
winter_urlaub	wi_+n_terure_-e_laue_-e_b
sonder_ausgabe	so_+n_derae_-e_u_+s_gabe
unterhaltung_+s_elektronik	u_+n_terhae_-e_le_-e_tu_+n_g_+s_ee_-e_lee_-e_k_tr_o_+n_ie_-e_k
nutz_last	n_u_tze_-e_la_+s_t
kultus_ministerium	kul_tu_+s_m_i_+n_i_+s_teriue_-e_m
web_browser	web_bro_w_+s_er
liebling_+s_buch	lieb_le_-e_i_+n_g_+s_buch
wertschöpfung_+s_kette	wer_t_+s_che_-e_öe_-e_pfu_+n_g_+s_ket_te
körper_gewicht	kö_rp_er_gee_-e_w_ie_-e_che_-e_t
flug_bahn	fl_ugbahn
reise_preis	r_e_i_+s_e_preie_-e_s
größe_+n_ordnung	g_r_ö_ß_+en_ordne_-e_une_-e_g
gans_+=e_haut	gä_+n_sehaue_-e_t
leistung_+s_empfänger	le_i_+s_tu_+n_g_+s_eme_-e_pe_-e_f_ä_+n_ger
sonne_+n_aufgang	so_+n_n_+en_aue_-e_fe_-e_ge_-e_ane_-e_g
wirtschaft_+s_informatik	wir_t_+s_chae_-e_ft_+s_i_+n_f_oe_-e_re_-e_m_atie_-e_k
fenster_bank	f_+en_se_-e_terbane_-e_k
nacht_schicht	na_che_-e_t_+s_che_-e_iche_-e_t
liebling_+s_lied	lieb_le_-e_i_+n_g_+s_l_ied
bund_+es_hauptstadt	bu_+n_d_+es_haue_-e_pe_-e_t_+s_te_-e_ade_-e_t
steuer_satz	st_euer_+s_ate_-e_z
kap_stadt	ka_p_+s_t_ade_-e_t
ball_besitz	ba_l_lbe_+s_ie_-e_te_-e_z
anbau_gebiet	a_+n_bae_-e_ue_-e_gebe_-e_iet
qualität_+s_verlust	qua_litäe_-e_t_+s_ve_-e_er_le_-e_u_+s_t
schule_-e_weg	sc_hue_-e_le_-e_we_-e_eg
messe_halle	m_+es_sehale_-e_le
wasser_kraft	wa_+s_sere_-e_krafe_-e_t
stil_mittel	st_ie_-e_le_-e_mittee_-e_l
sonntag_morgen	so_+n_n_tag_me_-e_orgen
leben_+s_kraft	leb_+en_se_-e_krafe_-e_t
wild_park	wilde_-e_pare_-e_k
handwerk_+s_kammer	hande_-e_wer_k_+s_ke_-e_ae_-e_m_mer
schutz_maßnahme	sc_hue_-e_te_-e_ze_-e_me_-e_ae_-e_ß_+n_ahe_-e_me_-e_e
presse_bericht	pr_+es_sebere_-e_ie_-e_che_-e_t
verkauf_+s_zahl	ver_ke_-e_au_f_+s_zahe_-e_l
nacht_zeit	n_a_chte_-e_zeie_-e_t
reparatur_kosten	r_e_parate_-e_ure_-e_k_o_+s_ten
turbo_lader	turbe_-e_oe_-e_lader
energie_erzeugung	e_+n_erge_-e_ieere_-e_zeu_ge_-e_une_-e_g
elektro_gerät	el_ee_-e_k_tr_ogeräe_-e_t
schwein_+e_fleisch	sc_he_-e_we_-e_ee_-e_i_+n_ee_-e_fe_-e_lei_+s_ce_-e_h
besucher_zahl	b_+es_uchere_-e_ze_-e_ahe_-e_l
fach_zeitschrift	fache_-e_zee_-e_i_t_+s_chrie_-e_fe_-e_t
greif_vogel	greie_-e_fe_-e_vogee_-e_l
einsatz_kraft	ei_+n_sate_-e_zkrafe_-e_t
sieg_punkt	si_eg_pe_-e_u_+n_ke_-e_t
advent_+s_kalender	a_d_v_+en_t_+s_ke_-e_ae_-e_l_+en_der
vorreiter_rolle	vorreiterre_-e_ole_-e_le
gesundheit_+s_reform	g_+es_undheit_+s_refore_-e_m
ort_+s_vorsteher	ort_+s_v_oe_-e_r_+s_teher
gedicht_band	gede_-e_ie_-e_chte_-e_be_-e_and
tag_+es_satz	ta_g_+es_sate_-e_z
projekt_management	pro_je_-e_ek_te_-e_manae_-e_gee_-e_m_+en_t
krebs_zelle	kreb_+s_zele_-e_le
staat_+s_angehörige	st_aae_-e_t_+s_a_+n_geh_öe_-e_ri_ge
herz_insuffizienz	he_re_-e_zi_+ns_ue_-e_fe_-e_fe_-e_izi_+en_z
standard_situation	s_t_andard_+s_ite_-e_uatie_-e_oe_-e_n
gang_art	ga_+n_ge_-e_are_-e_t
kommando_zeile	ko_m_mande_-e_ozeie_-e_le
haus_technik	ha_u_+s_tech_+n_ie_-e_k
kraft_fahrzeug	kra_fe_-e_te_-e_fahre_-e_zeue_-e_g
kunde_+n_kontakt	ku_+n_d_+en_ke_-e_o_+n_tae_-e_ke_-e_t
investition_+s_kosten	i_n_ve_-e_e_+s_te_-e_ie_-e_ti_o_+n_s_ke_-e_o_+s_ten
markt_anteil	mar_kte_-e_a_+n_teie_-e_l
luft_bild	lu_ftbie_-e_ld
liste_+n_preis	li_+s_t_+en_pe_-e_reie_-e_s
bau_land	ba_ue_-e_le_-e_and
finanz_dienstleister	fi_+n_a_+n_zde_-e_i_+en_ste_-e_lei_+s_ter
ton_art	to_+n_are_-e_t
produktion_+s_anlage	pr_oe_-e_du_ke_-e_ti_o_+ns_ane_-e_lage
gefährdung_+s_beurteilung	ge_f_ährdu_+n_g_+s_beure_-e_tei_le_-e_u_+n_g
note_+n_bank	n_o_t_+en_bane_-e_k
kauf_empfehlung	kau_fee_-e_m_pe_-e_feh_le_-e_une_-e_g
mittag_+s_zeit	mittag_+s_zeie_-e_t
test_fahrt	t_+es_te_-e_fahre_-e_t
schütze_+n_fest	sc_he_-e_üe_-e_tz_+en_f_+es_t
gast_gewerbe	ga_+s_te_-e_gee_-e_werbe
arbeit_+s_schwerpunkt	ar_bee_-e_it_+s_sche_-e_we_-e_er_pe_-e_u_+n_ke_-e_t
abt_rennung	a_b_trenne_-e_une_-e_g
stadt_archiv	st_adtarchie_-e_v
viertel_jahr	viere_-e_tel_je_-e_ah_r
finanz_behörde	fi_+n_ane_-e_ze_-e_beh_öe_-e_rde
menschenrecht_+s_organisation	m_+en_sch_+en_reche_-e_t_+s_org_a_+n_i_+s_atie_-e_oe_-e_n
pfarre_-e_heim	pfarrheie_-e_m
arbeit_+s_bereich	ar_bee_-e_ie_-e_t_+s_beree_-e_ich
klasse_+n_lehrerin	kla_+s_s_+en_lehrerie_-e_n
lage_plan	la_gee_-e_p_lan
wissen_+s_wert	wi_+s_s_+en_se_-e_we_-e_ere_-e_t
sonne_+n_schein	so_+n_n_+en_sce_-e_heie_-e_n
klasse_+n_raum	kla_+s_senraue_-e_m
studie_+n_beratung	s_t_ude_-e_i_+en_berae_-e_te_-e_une_-e_g
aufklärung_+s_arbeit	au_fe_-e_ke_-e_le_-e_äru_+n_g_+s_arbeie_-e_t
beruf_+s_ausübung	berue_-e_f_+s_ae_-e_u_+s_übe_-e_u_+n_g
bildung_+s_weg	b_i_ldu_+n_g_+s_we_-e_eg
schule_-e_medizin	sc_hue_-e_l_medize_-e_in
ziel_vorstellung	ziel_ve_-e_or_+s_tee_-e_l_le_-e_u_+n_g
arbeit_+s_lohn	ar_bee_-e_ie_-e_t_+s_l_oe_-e_hn
entwicklung_+s_zusammenarbeit	en_te_-e_we_-e_ic_k_le_-e_u_+n_g_+s_zu_+s_ae_-e_m_m_+en_arbeie_-e_t
zeit_punkt	zeite_-e_pu_+n_ke_-e_t
hintergrund_information	hi_+n_tere_-e_grunde_-e_i_+n_f_oe_-e_re_-e_m_at_ie_-e_oe_-e_n
ton_höhe	to_+n_h_öe_-e_he
kilo_gramm	ki_l_ograme_-e_m
kunst_verein	ku_+n_se_-e_te_-e_vereie_-e_n
fußball_verein	fu_ßbale_-e_le_-e_vereie_-e_n
schadenersatz_anspruch	s_c_hadener_+s_ate_-e_za_+ns_pruce_-e_h
bund_+es_bank	bu_+n_d_+es_bane_-e_k
luft_strom	le_-e_u_ft_+s_troe_-e_m
zauber_spruch	za_ue_-e_ber_+s_pruce_-e_h
bund_+es_wettbewerb	bu_+n_de_+s_wet_te_-e_bee_-e_were_-e_b
berg_steiger	be_rg_+s_tee_-e_i_ger
löwe_+n_zahn	l_ö_w_+en_zahn
nachbar_staat	na_chbar_+s_te_-e_aae_-e_t
heu_schnupfen	he_u_+s_chnue_-e_pe_-e_fen
kampf_system	kam_pe_-e_f_+s_y_+s_tee_-e_m
umwelt_zone	u_m_wel_te_-e_z_o_+n_e
regierung_+s_erklärung	r_e_ge_-e_iere_-e_u_+n_g_+s_ere_-e_ke_-e_le_-e_äru_+n_g
beruf_+s_ausbildung	berue_-e_f_+s_au_+s_be_-e_ie_-e_ldune_-e_g
abteilung_+s_leiter	a_b_tei_le_-e_u_+n_g_+s_lee_-e_i_ter
kosten_entscheidung	ko_+s_t_+en_ent_+s_ce_-e_hee_-e_idune_-e_g
koalition_+s_verhandlung	koal_iti_o_+ns_ve_-e_er_hande_-e_le_-e_une_-e_g
advent_+s_zeit	a_d_v_+en_t_+s_zeie_-e_t
produkt_gruppe	pr_oe_-e_du_ktgrupe_-e_pe_-e_e
leistung_+s_fähigkeit	le_i_+s_tu_+n_g_+s_f_äe_-e_hi_ge_-e_keie_-e_t
umwelt_problem	u_m_wel_te_-e_pe_-e_re_-e_o_be_-e_lee_-e_m
rechnung_+s_betrag	r_e_ch_+n_u_+n_g_+s_bee_-e_trae_-e_g
über_einkunft	ub_+=er_ee_-e_i_+n_k_u_+n_fe_-e_t
herz_infarkt	herze_-e_i_+n_farke_-e_t
problem_stellung	pro_be_-e_lee_-e_m_+s_tee_-e_l_le_-e_u_+n_g
lebensmittel_sicherheit	leb_+en_se_-e_me_-e_it_tee_-e_l_+s_icherheie_-e_t
wissen_+s_vermittlung	wi_+s_s_+en_se_-e_ve_-e_er_me_-e_ittle_-e_u_+n_g
nachkriegs_zeit	na_che_-e_ke_-e_re_-e_ieg_+s_zeie_-e_t
beratung_+s_angebot	be_rae_-e_te_-e_u_+n_g_+s_a_+n_gebe_-e_oe_-e_t
fan_gemeinde	fa_+n_gee_-e_mee_-e_i_+n_de
bund_+es_amt	bu_+n_d_+es_ae_-e_me_-e_t
boot_+s_haus	b_o_oe_-e_t_+s_haue_-e_s
körper_kontakt	korp_+=er_ke_-e_o_+n_tae_-e_ke_-e_t
meer_+es_spiegel	meer_+es_se_-e_piegee_-e_l
unterricht_+s_stunde	u_+n_terre_-e_iche_-e_t_+s_ste_-e_u_+n_de
tod_+es_angst	to_d_+es_a_+n_g_+s_t
tausch_börse	ta_u_+s_chbe_-e_ör_+s_e
staat_+s_regierung	st_aae_-e_t_+s_ree_-e_ge_-e_ierune_-e_g
forst_amt	for_+s_tae_-e_me_-e_t
arbeit_+s_stunde	ar_bee_-e_i_t_+s_ste_-e_u_+n_de
punkt_gewinn	pu_+n_k_tgee_-e_w_inn
sonne_+n_energie	so_+n_n_+en_energe_-e_ie
rückgabe_recht	rü_ce_-e_k_ge_-e_a_bereche_-e_t
bezirk_+s_klasse	b_e_ze_-e_ire_-e_k_+s_k_la_+s_se
name_+ns_schild	n_a_m_+en_s_+s_chie_-e_ld
vanille_zucker	va_+n_ie_-e_le_-e_lezuce_-e_ker
staat_+s_theater	st_aae_-e_t_+s_te_-e_heae_-e_ter
oktober_fest	ok_to_bere_-e_f_+es_t
polizei_einsatz	polie_-e_zee_-e_iee_-e_in_+s_ate_-e_z
sport_verein	s_p_ort_vereie_-e_n
viertel_finale	viere_-e_tee_-e_l_fi_+n_ale
druck_sache	d_r_uce_-e_k_+s_ache
putz_frau	put_ze_-e_frae_-e_u
chef_arzt	chee_-e_farze_-e_t
quelle_-e_code	quele_-e_lcode
investment_fond	i_n_v_+es_te_-e_m_+en_te_-e_fe_-e_o_+n_d
wasser_leitung	wa_+s_sere_-e_lee_-e_i_te_-e_u_+n_g
tier_haltung	tierhale_-e_te_-e_u_+n_g
energie_bedarf	e_+n_erge_-e_iebedare_-e_f
karte_+n_spiel	kar_t_+en_se_-e_pe_-e_iee_-e_l
reich_+s_stadt	r_e_ich_+s_se_-e_te_-e_ade_-e_t
anziehung_+s_punkt	a_+n_ze_-e_ieh_u_+n_g_+s_pe_-e_u_+n_ke_-e_t
über_blick	ub_+=er_ble_-e_ice_-e_k
kind_+er_tagesstätte	ki_+n_dere_-e_tae_-e_g_+es_ste_-e_ätte
fischer_dorf	fi_+s_cherde_-e_ore_-e_f
ritter_gut	r_i_ttergue_-e_t
volk_+s_republik	vo_l_k_+s_ree_-e_publie_-e_k
gast_wirt	ga_+s_te_-e_we_-e_ire_-e_t
fach_begriff	fachbegrie_-e_fe_-e_f
test_verfahren	t_+es_te_-e_ve_-e_er_fae_-e_hren
presse_rat	pr_+es_serae_-e_t
protest_aktion	pr_o_t_+es_take_-e_tie_-e_oe_-e_n
angel_punkt	a_+n_gel_pe_-e_u_+n_ke_-e_t
stadtverordnete_+n_versammlung	st_adt_ve_-e_er_ordnee_-e_t_+en_ver_+s_ae_-e_me_-e_mlu_+n_g
blume_+n_topf	bl_ue_-e_m_+en_toe_-e_pe_-e_f
musik_stück	mu_+s_ie_-e_k_+s_tüce_-e_k
strom_verbrauch	stro_me_-e_ver_brauce_-e_h
bund_+es_versammlung	bu_+n_de_+s_ver_+s_ae_-e_me_-e_mlu_+n_g
erz_bistum	e_r_zbe_-e_i_+s_tue_-e_m
planung_+s_phase	pla_+n_u_+n_g_+s_phe_-e_a_+s_e
kind_+er_armut	ki_+n_derare_-e_me_-e_ue_-e_t
armut_+s_bekämpfung	a_r_me_-e_ue_-e_t_+s_beke_-e_äe_-e_me_-e_pfu_+n_g
mail_adresse	mai_ladr_+es_se
entwicklung_+s_stufe	en_te_-e_we_-e_ic_k_le_-e_u_+n_g_+s_stue_-e_fe
wasser_masse	wa_+s_sere_-e_me_-e_a_+s_se
saison_spiel	s_a_i_+s_o_+n_s_pe_-e_iee_-e_l
bürger_haus	bü_rgerhaue_-e_s
ausland_+s_semester	au_+s_le_-e_and_+s_see_-e_me_+s_ter
kosten_grund	ko_+s_t_+en_gre_-e_und
kooperation_+s_vertrag	ko_o_perate_-e_ie_-e_o_+ns_ver_te_-e_rae_-e_g
arbeit_+s_verhältnis	ar_beie_-e_t_+s_verhe_-e_äle_-e_t_+n_ie_-e_s
produktion_+s_kosten	pr_oe_-e_du_ke_-e_ti_o_+n_s_ke_-e_o_+s_ten
park_möglichkeit	parke_-e_me_-e_ögl_iche_-e_keie_-e_t
ehe_leute	eh_ee_-e_leue_-e_te
tätigkeit_+s_feld	tä_ti_ge_-e_kei_t_+s_fele_-e_d
telefon_anschluss	te_le_-e_ee_-e_f_o_+n_an_+s_che_-e_le_-e_u_+s_s
beruf_+s_feuerwehr	berue_-e_f_+s_feuer_we_-e_ehe_-e_r
auftakt_veranstaltung	a_u_fe_-e_take_-e_te_-e_ver_a_+ns_tae_-e_lte_-e_u_+n_g
religion_+s_freiheit	r_e_lie_-e_gi_o_+ns_fre_ie_-e_heie_-e_t
kern_aufgabe	kernaufe_-e_gabe
sache_-e_kenntnis	sa_che_-e_k_+en_ne_-e_t_+n_ie_-e_s
schlaf_platz	sc_he_-e_lae_-e_f_pe_-e_late_-e_z
bruch_stück	br_uch_+s_tüce_-e_k
entwicklung_+s_prozess	en_te_-e_we_-e_ic_k_le_-e_u_+n_g_+s_pe_-e_re_-e_o_z_+es_s
geist_+es_wissenschaft	ge_i_+s_te_+s_we_-e_i_+s_s_+en_schafe_-e_t
bild_zeitung	b_i_ldzee_-e_i_te_-e_u_+n_g
lohn_arbeit	lo_h_+n_arbeie_-e_t
kammer_spiel	ka_m_mer_+s_pe_-e_iee_-e_l
drehbuch_autor	dr_ehbuchaute_-e_oe_-e_r
vertrauen_+s_verhältnis	ver_trae_-e_u_+en_se_-e_verhe_-e_äle_-e_t_+n_ie_-e_s
pflege_dienst	pf_legede_-e_i_+en_se_-e_t
absicht_+s_erklärung	ab_+s_ie_-e_ch_t_+s_ere_-e_ke_-e_le_-e_äru_+n_g
floh_markt	fl_ohe_-e_me_-e_arke_-e_t
waffe_+n_gewalt	waf_f_+en_gee_-e_wal_t
regierung_+s_präsidium	r_e_ge_-e_iere_-e_u_+n_gse_-e_pe_-e_re_-e_ä_+s_idiue_-e_m
wille_+ns_bildung	wi_l_l_+en_sbe_-e_ie_-e_ldune_-e_g
sieger_ehrung	si_ee_-e_gerehre_-e_une_-e_g
arbeit_+s_leistung	ar_beie_-e_t_+s_lee_-e_i_+s_tune_-e_g
monat_+s_ende	mo_+n_a_t_+s_ende
bürger_versammlung	büre_-e_ger_ver_+s_ae_-e_me_-e_mlu_+n_g
fußboden_heizung	fu_ße_-e_be_-e_odenhei_ze_-e_u_+n_g
blick_punkt	bl_ick_pu_+n_ke_-e_t
beweis_mittel	b_e_wei_+s_m_ittee_-e_l
himmel_reich	h_i_me_-e_melreich
gemeinde_zentrum	g_e_me_-e_ee_-e_i_+n_dee_-e_z_+en_true_-e_m
traum_welt	traue_-e_me_-e_wel_t
bachelor_studiengang	bace_-e_hee_-e_l_or_+s_te_-e_ude_-e_i_+en_ge_-e_ane_-e_g
bund_+es_anwaltschaft	bu_+n_d_+es_a_+n_we_-e_ae_-e_l_t_+s_chafe_-e_t
natur_wissenschaft	n_a_te_-e_ure_-e_w_i_+s_s_+en_schafe_-e_t
übergang_+s_regelung	ub_+=er_ge_-e_ane_-e_g_+s_regee_-e_l_une_-e_g
schach_zug	sc_hachzue_-e_g
training_+s_plan	trae_-e_i_+n_i_+n_g_+s_p_lan
bund_+es_gericht	bu_+n_d_+es_gere_-e_ie_-e_che_-e_t
linie_+n_bus	li_+n_i_+en_bus
markt_platz	mar_ke_-e_te_-e_p_late_-e_z
jahr_+es_tag	jah_r_+es_tae_-e_g
bau_firma	baufe_-e_irme_-e_a
tier_schutz	tier_+s_chute_-e_z
katastrophe_+n_schutz	kata_+s_tre_-e_o_ph_+en_schute_-e_z
meer_+es_boden	mee_r_+es_be_-e_oe_-e_den
ware_+n_zeichen	war_+en_zee_-e_ice_-e_hen
bildung_+s_stätte	b_i_ldu_+n_g_+s_ste_-e_ätte
ende_-e_stufe	e_+n_d_+s_tue_-e_fe
treibhaus_effekt	tree_-e_ie_-e_bhae_-e_u_+s_efe_-e_feke_-e_t
sache_-e_bearbeiter	sa_che_-e_bearbee_-e_i_ter
kultur_zentrum	kul_ture_-e_z_+en_true_-e_m
rand_bereich	ra_ndberee_-e_ich
forschung_+s_stelle	for_+s_chu_+n_g_+s_stele_-e_le
reihe_+n_folge	r_e_ih_+en_fe_-e_olge
information_+s_angebot	i_+n_f_oe_-e_re_-e_m_at_ie_-e_o_+ns_angebe_-e_oe_-e_t
energie_feld	e_+n_erge_-e_iee_-e_fele_-e_d
computer_system	c_o_me_-e_puter_+s_y_+s_tee_-e_m
halle_+n_bad	h_a_l_l_+en_bad
verlag_+s_haus	ver_lae_-e_g_+s_haue_-e_s
haus_bank	ha_u_+s_bane_-e_k
staat_+s_kasse	st_aae_-e_t_+s_ka_+s_se
mitglied_+s_land	mite_-e_ge_-e_l_ied_+s_le_-e_and
volk_+s_lied	vol_k_+s_l_ied
staat_+s_archiv	st_aae_-e_t_+s_archie_-e_v
natur_kosmetik	n_a_turke_-e_o_+s_metie_-e_k
leben_+s_gestaltung	leb_+en_sge_+s_tae_-e_lte_-e_u_+n_g
fußball_spieler	fu_ßbale_-e_l_+s_p_ieler
diskussion_+s_rund	di_se_-e_k_u_+s_se_-e_ie_-e_o_+n_sre_-e_und
bahn_linie	ba_h_+n_le_-e_i_+n_ie
glas_haus	gl_a_+s_haue_-e_s
bonus_punkt	bo_+n_u_+s_pe_-e_u_+n_ke_-e_t
kartei_karte	kar_tei_ke_-e_arte
rechen_zentrum	re_ce_-e_h_+en_z_+en_true_-e_m
post_amt	po_+s_tae_-e_me_-e_t
leben_+s_bereich	leb_+en_sberee_-e_ich
person_+en_verkehr	per_+s_o_+n_e_+n_ve_-e_er_kehe_-e_r
feuerwerk_+s_körper	feuer_wer_k_+s_k_öe_-e_rp_er
dienst_wagen	di_+en_ste_-e_wagen
leistung_+s_druck	le_i_+s_t_u_+n_g_+s_druce_-e_k
öffnung_+s_zeit	öff_+n_u_+n_g_+s_zeie_-e_t
schraube_+n_zieher	sc_hraue_-e_b_+en_ziee_-e_her
wahl_gang	wah_le_-e_ge_-e_ane_-e_g
mond_licht	mo_+n_dle_-e_ie_-e_che_-e_t
internet_verbindung	i_+n_ternete_-e_ver_be_-e_inde_-e_une_-e_g
spitze_+n_gruppe	s_p_ie_-e_t_z_+en_grupe_-e_pe_-e_e
aktion_+s_tag	ak_ti_o_+n_stae_-e_g
band_scheibe	ba_+n_d_+s_cheibe
gemeinde_mitglied	g_e_me_-e_ee_-e_i_+n_dee_-e_me_-e_ie_-e_tglied
land_+es_teil	la_+n_d_+es_teie_-e_l
hand_bewegung	handbee_-e_weg_une_-e_g
park_anlage	par_ke_-e_an_lage
leben_+s_geschichte	leb_+en_sg_+es_chichte
erde_-e_geschoss	er_dg_+es_che_-e_o_+s_s
anschluss_treffer	a_+n_sche_-e_le_-e_u_+s_se_-e_te_-e_ref_fer
bau_kosten	ba_ue_-e_ke_-e_o_+s_ten
bahnhof_straße	ba_hnhe_-e_oe_-e_f_+s_traße
industrie_land	i_+n_du_+s_tre_-e_iee_-e_land
test_phase	t_+es_te_-e_pe_-e_ha_+s_e
wasser_qualität	wa_+s_sere_-e_qua_le_-e_ite_-e_äe_-e_t
maschine_+n_bau	ma_+s_ce_-e_he_-e_i_+n_ene_-e_bae_-e_u
frage_stellung	fra_ge_+s_tee_-e_l_le_-e_u_+n_g
haft_strafe	h_a_fe_-e_t_+s_trafe
rat_+s_herr	r_a_t_+s_herr
sache_-e_preis	sa_che_-e_preie_-e_s
stelle_+n_abbau	st_ee_-e_l_l_+en_abe_-e_bae_-e_u
krankheit_+s_fall	kra_+n_ke_-e_heit_+s_fale_-e_l
haus_verbot	ha_u_+s_verbe_-e_oe_-e_t
rücken_mark	rü_ce_-e_k_+en_me_-e_are_-e_k
regierung_+s_bezirk	r_e_ge_-e_iere_-e_u_+n_g_+s_bezire_-e_k
finanz_ausschuss	fi_+n_a_+n_zau_+s_sche_-e_u_+s_s
grund_schüler	gr_und_+s_che_-e_üe_-e_ler
information_+s_pflicht	i_+n_f_oe_-e_re_-e_m_at_ie_-e_o_+n_s_pe_-e_fe_-e_liche_-e_t
start_guthaben	st_arte_-e_ge_-e_ue_-e_thae_-e_ben
elektro_motor	el_ee_-e_k_troe_-e_me_-e_ote_-e_oe_-e_r
stadt_bibliothek	st_adtbibe_-e_le_-e_ie_-e_othee_-e_k
medizin_studium	med_ie_-e_ze_-e_i_+n_s_tudiue_-e_m
rüstung_+s_industrie	rü_+s_t_u_+n_g_+s_i_+n_du_+s_trie
werk_vertrag	wer_ke_-e_ve_-e_er_te_-e_rae_-e_g
as_sang	a_+s_sane_-e_g
wald_boden	wal_db_oe_-e_den
bild_unterschrift	b_i_ldu_+n_ter_+s_chrie_-e_fe_-e_t
ware_+n_wert	war_+en_we_-e_ere_-e_t
golf_platz	go_le_-e_f_plate_-e_z
ballung_+s_raum	ba_le_-e_le_-e_u_+n_g_+s_raue_-e_m
fels_brocken	fel_+s_bre_-e_oce_-e_ke_-e_en
nord_west	no_rd_w_+es_t
lied_gut	liedgue_-e_t
umwelt_bedingung	u_m_we_-e_el_tbede_-e_i_+n_g_une_-e_g
schüler_gruppe	sc_he_-e_üe_-e_lergrupe_-e_pe_-e_e
arbeit_+s_mittel	ar_beie_-e_t_+s_mittee_-e_l
gesundheit_+s_zentrum	g_+es_undhee_-e_ie_-e_t_+s_z_+en_true_-e_m
regen_wurm	r_e_g_+en_we_-e_ure_-e_m
schule_-e_unterricht	sc_hue_-e_le_-e_u_+n_terre_-e_iche_-e_t
bank_geschäft	ba_+n_kg_+es_chäe_-e_fe_-e_t
stadt_rand	st_adtrand
immobilie_+n_markt	im_me_-e_obi_le_-e_i_+en_me_-e_arke_-e_t
eis_zeit	e_i_+s_zeie_-e_t
finanz_produkt	fi_+n_a_+n_ze_-e_pe_-e_roe_-e_due_-e_ke_-e_t
hand_fläche	ha_+n_dfle_-e_äche
wetter_lage	wet_tere_-e_lage
leistung_+s_sport	le_i_+s_tu_+n_g_+s_spore_-e_t
reaktion_+s_zeit	reae_-e_ke_-e_ti_o_+ns_zeie_-e_t
betrieb_+s_rat	be_tre_-e_ieb_+s_rae_-e_t
friede_+ns_vertrag	fr_iede_+ns_ver_te_-e_rae_-e_g
staat_+s_gebiet	st_aat_+s_gebe_-e_iet
auswahl_möglichkeit	au_+s_we_-e_ahle_-e_me_-e_öe_-e_gl_iche_-e_keie_-e_t
breite_+n_grad	bree_-e_ie_-e_t_+en_grad
jahr_markt	jahre_-e_me_-e_arke_-e_t
prüfung_+s_amt	prü_fe_-e_u_+n_g_+s_ame_-e_t
übersicht_+s_karte	ub_+=er_siche_-e_t_+s_karte
verein_+s_vorsitzende	veree_-e_i_+ns_vor_+s_ie_-e_te_-e_z_+en_de
rate_+n_kredit	r_a_t_+en_kredie_-e_t
ehe_frau	eh_ee_-e_frae_-e_u
sprache_-e_kurs	sp_rache_-e_kurs
buch_form	bu_chfore_-e_m
haupt_darsteller	ha_ue_-e_pe_-e_tdar_+s_tee_-e_l_ler
verhalten_+s_weise	ver_hae_-e_le_-e_ten_+s_wee_-e_i_+s_e
licht_strahl	liche_-e_t_+s_trahe_-e_l
konflikt_situation	ko_+n_f_le_-e_i_ke_-e_t_+s_ite_-e_uatie_-e_oe_-e_n
gold_medaille	go_ld_medae_-e_ile_-e_le
haupt_preis	ha_ue_-e_pe_-e_tpreie_-e_s
lauf_werk	laufe_-e_we_-e_ere_-e_k
markt_forschung	mar_ke_-e_te_-e_f_or_+s_che_-e_une_-e_g
industrie_nation	i_+n_du_+s_tre_-e_i_+en_atie_-e_oe_-e_n
einzug_+s_bereich	ei_+n_z_ue_-e_g_+s_beree_-e_ich
dino_saurier	di_+n_o_+s_aure_-e_ier
einsatz_fahrzeug	ei_+n_sae_-e_te_-e_ze_-e_fahre_-e_zeue_-e_g
post_karte	po_+s_t_ke_-e_arte
natur_gesetz	n_a_te_-e_ure_-e_g_+es_ete_-e_z
gehirn_wäsche	geh_ir_+n_w_ä_+s_che
hochwasser_schutz	ho_ch_we_-e_a_+s_ser_+s_chute_-e_z
tarif_verhandlung	tarie_-e_fe_-e_ver_hande_-e_le_-e_une_-e_g
volk_+s_schule	vo_l_k_+s_schue_-e_le
acker_fläche	a_c_kerfle_-e_äche
not_aufnahme	n_o_tau_f_+n_ahe_-e_me_-e_e
tier_welt	tier_we_-e_el_t
bett_wäsche	bette_-e_w_ä_+s_che
terror_anschlag	terre_-e_oran_+s_che_-e_lae_-e_g
ball_verlust	ba_le_-e_le_-e_ver_le_-e_u_+s_t
dienst_zeit	di_+en_ste_-e_zeie_-e_t
feuerwehr_mann	feuer_weh_re_-e_mann
redaktion_+s_schluss	redae_-e_ke_-e_ti_o_+n_s_+s_che_-e_le_-e_u_+s_s
fach_gebiet	fache_-e_gebe_-e_iet
sonntag_nachmittag	so_+n_n_tag_+n_ache_-e_mittae_-e_g
schlaf_raum	sc_he_-e_lae_-e_fraue_-e_m
vertrag_+s_staat	ver_trae_-e_g_+s_ste_-e_aae_-e_t
beruf_+s_einstieg	berue_-e_f_+s_e_i_+ns_te_-e_ieg
probe_zeit	pr_o_bezeie_-e_t
wartung_+s_arbeit	war_te_-e_u_+n_g_+s_arbeie_-e_t
persönlichkeit_+s_störung	per_+s_ö_+n_l_ie_-e_che_-e_ke_-e_ei_t_+s_se_-e_te_-e_öru_+n_g
gesicht_+s_ausdruck	g_+es_iche_-e_t_+s_ae_-e_u_+s_druce_-e_k
bau_jahr	ba_ue_-e_je_-e_ah_r
fitness_studio	fi_t_+n_e_+s_s_+s_te_-e_udie_-e_o
song_text	so_+n_g_texe_-e_t
klima_erwärmung	kl_i_maere_-e_we_-e_äe_-e_rm_u_+n_g
produkt_palette	pr_oe_-e_du_ke_-e_te_-e_palete_-e_te
verkehr_+s_unternehmen	ver_ke_-e_eh_r_+s_u_+n_ternehe_-e_me_-e_en
bau_abschnitt	ba_uab_+s_chnie_-e_te_-e_t
rest_risiko	r_+es_tri_+s_ie_-e_ke_-e_o
armut_+s_zeugnis	a_r_me_-e_ue_-e_t_+s_zeu_g_+n_ie_-e_s
produkt_beschreibung	pr_oe_-e_du_ke_-e_tb_+es_chreie_-e_be_-e_une_-e_g
atem_weg	atee_-e_m_we_-e_eg
handlung_+s_weise	ha_+n_dle_-e_u_+n_g_+s_wee_-e_i_+s_e
energie_berater	e_+n_erge_-e_ieberae_-e_ter
tat_ort	tatore_-e_t
medizin_technik	med_ie_-e_ze_-e_i_+n_tech_+n_ie_-e_k
bau_teil	ba_ue_-e_teie_-e_l
amt_+s_antritt	a_m_t_+s_a_+n_tre_-e_ite_-e_t
gewinn_spiel	g_e_w_i_+n_n_+s_pe_-e_iee_-e_l
einsatz_leiter	ei_+n_sate_-e_ze_-e_lei_ter
einsatz_ort	ei_+n_satze_-e_ore_-e_t
aktie_+n_gesellschaft	a_k_te_-e_i_+en_g_+es_ee_-e_le_-e_l_+s_chafe_-e_t
fach_sprache	fach_+s_prache
geist_+es_haltung	ge_i_+s_t_+es_hale_-e_te_-e_u_+n_g
personal_abteilung	per_+s_o_+n_a_labe_-e_tei_le_-e_u_+n_g
risiko_bewertung	ri_+s_i_koe_-e_be_we_-e_er_te_-e_une_-e_g
börse_+n_gang	bö_r_+s_ene_-e_ge_-e_ane_-e_g
welt_klasse	wel_te_-e_kla_+s_se
gewerkschaft_+s_bund	g_e_we_-e_er_k_+s_c_hae_-e_fe_-e_t_+s_bund
überzeugung_+s_arbeit	ub_+=er_zeu_ge_-e_u_+n_g_+s_arbeie_-e_t
vorbild_funktion	vorb_ie_-e_ldf_u_+n_ke_-e_tie_-e_oe_-e_n
konfiguration_+s_datei	ko_+n_f_ie_-e_gurae_-e_te_-e_ie_-e_o_+n_sdae_-e_tee_-e_i
gewinn_chance	g_e_w_i_+n_nche_-e_a_+n_ce
wirtschaft_+s_gut	wir_t_+s_chae_-e_ft_+s_gue_-e_t
computer_programm	c_o_me_-e_putere_-e_pe_-e_re_-e_o_grame_-e_m
rampe_+n_licht	r_a_m_p_+en_le_-e_ie_-e_che_-e_t
therapie_form	therae_-e_pe_-e_iefore_-e_m
schluss_strich	sc_he_-e_le_-e_u_+s_s_+s_tre_-e_ich
geld_institut	ge_lde_-e_i_+n_ste_-e_itue_-e_t
not_arzt	n_o_tarze_-e_t
heimat_ort	heie_-e_me_-e_at_ore_-e_t
foul_elfmeter	foulel_fe_-e_meter
job_angebot	joba_+n_gebe_-e_oe_-e_t
entwicklung_+s_politik	en_te_-e_we_-e_ic_k_le_-e_u_+n_g_+s_pe_-e_olitie_-e_k
fach_ausschuss	fachau_+s_sche_-e_u_+s_s
qualität_+s_entwicklung	qua_le_-e_ie_-e_te_-e_ä_t_+s_ente_-e_we_-e_ic_k_le_-e_u_+n_g
verbraucher_zentrale	ver_braue_-e_chere_-e_z_+en_trale
bild_material	bi_lde_-e_m_ae_-e_teriae_-e_l
gewalt_anwendung	g_e_we_-e_ae_-e_l_ta_+n_w_+en_dune_-e_g
quant_+en_sprung	qua_+n_t_+en_se_-e_pru_+n_g
glaube_+ns_gemeinschaft	gl_ae_-e_u_ben_+s_gee_-e_me_-e_ee_-e_i_+n_schafe_-e_t
versicherung_+s_schutz	ver_+s_ie_-e_chere_-e_u_+n_g_+s_schute_-e_z
kern_aussage	ker_+n_ae_-e_u_+s_sage
deutschland_funk	d_e_ut_+s_che_-e_lande_-e_fe_-e_u_+n_k
kur_fürst	kur_f_üe_-e_r_+s_t
produkt_entwicklung	pr_oe_-e_du_kt_+en_te_-e_we_-e_ic_k_le_-e_u_+n_g
art_+en_schutz	a_r_t_+en_schute_-e_z
leben_+s_qualität	leb_+en_se_-e_qua_le_-e_ite_-e_äe_-e_t
begegnung_+s_stätte	be_geg_+n_u_+n_g_+s_ste_-e_ätte
liebe_+s_beziehung	liebe_+s_bee_-e_z_ieh_une_-e_g
geld_menge	ge_lde_-e_m_+en_ge
ruhe_phase	ru_hee_-e_phe_-e_a_+s_e
uni_klinik	u_+n_ie_-e_kli_+n_ie_-e_k
beschluss_fassung	b_+es_che_-e_le_-e_u_+s_se_-e_fa_+s_se_-e_une_-e_g
kommunikation_+s_fähigkeit	ko_m_mu_+n_i_ke_-e_at_ie_-e_o_+n_s_fe_-e_äe_-e_hi_ge_-e_keie_-e_t
elektro_technik	el_ee_-e_k_tr_o_tech_+n_ie_-e_k
freizeit_park	fre_ie_-e_zeite_-e_pe_-e_are_-e_k
flut_licht	fl_utle_-e_iche_-e_t
rand_bedingung	ra_ndbede_-e_i_+n_g_une_-e_g
internet_anschluss	i_+n_ternee_-e_ta_+ns_che_-e_le_-e_u_+s_s
strom_anschluss	st_re_-e_o_man_+s_che_-e_le_-e_u_+s_s
haupt_anliegen	ha_ue_-e_pe_-e_ta_+n_liee_-e_gen
schrift_+en_reihe	sc_hre_-e_ie_-e_fe_-e_t_+en_reihe
bund_+es_recht	bu_+n_d_+es_reche_-e_t
einfall_+s_reichtum	ei_+n_fe_-e_ae_-e_l_l_+s_reichtue_-e_m
foul_spiel	foul_+s_p_iee_-e_l
hund_+e_rasse	hu_+n_dere_-e_a_+s_se
ausgang_+s_situation	au_+s_gang_+s_site_-e_uatie_-e_oe_-e_n
bau_stein	ba_u_+s_teie_-e_n
inhalt_+s_verzeichnis	i_+n_hale_-e_t_+s_ve_-e_er_zee_-e_ich_+n_ie_-e_s
zahl_+en_wert	zah_l_+en_we_-e_ere_-e_t
zusatz_leistung	zu_+s_ate_-e_ze_-e_lei_+s_tune_-e_g
grenze_-e_wert	gr_+en_ze_-e_we_-e_ere_-e_t
stadt_staat	st_adt_+s_taae_-e_t
verkehr_+s_infrastruktur	ver_ke_-e_eh_r_+s_i_+n_fra_+s_true_-e_ktue_-e_r
theater_aufführung	theateraue_-e_fe_-e_fe_-e_ührune_-e_g
rebe_-e_sorte	re_b_+s_orte
tat_+en_drang	ta_t_+en_drane_-e_g
jugend_gruppe	jug_+en_de_-e_grupe_-e_pe_-e_e
spende_+n_geld	sp_+en_d_+en_geld
familie_+n_angehörige	fe_-e_a_m_ie_-e_l_i_+en_a_+n_geh_öe_-e_ri_ge
sicherheit_+s_standard	si_chere_-e_hee_-e_i_t_+s_se_-e_tandard
reise_bus	r_e_i_+s_ebus
zukunft_+s_perspektive	ze_-e_u_ku_+n_fe_-e_t_+s_per_+s_pee_-e_k_tie_-e_ve_-e_e
spiel_+e_konsole	s_p_ielee_-e_k_o_+ns_oe_-e_le
staat_+s_rat	st_aat_+s_rae_-e_t
wettbewerb_+s_fähigkeit	wet_te_-e_bee_-e_wer_b_+s_fe_-e_äe_-e_hi_ge_-e_keie_-e_t
ausländer_behörde	au_+s_l_ä_+n_dere_-e_beh_öe_-e_rde
beifahrer_sitz	b_e_i_fe_-e_ahrer_+s_ie_-e_te_-e_z
buch_+=er_regal	bü_cherregae_-e_l
markt_einführung	mar_ke_-e_tee_-e_i_+n_f_üe_-e_hrune_-e_g
würde_+n_träger	würd_+en_tre_-e_ä_ger
schach_spiel	sc_hach_+s_pe_-e_iee_-e_l
nichts_tun	ni_cht_+s_tun
mensch_+en_verstand	m_+en_sce_-e_h_+en_ver_+s_te_-e_and
beruf_+s_wahl	berue_-e_f_+s_wahe_-e_l
internet_auftritt	i_+n_ternee_-e_taue_-e_ftrite_-e_t
haus_herr	ha_u_+s_herr
rechnung_+s_wesen	r_e_chnu_+n_g_+s_w_+es_en
wald_gebiet	waldgebe_-e_iet
sitz_position	si_te_-e_ze_-e_po_+s_itie_-e_oe_-e_n
nutzung_+s_dauer	n_u_te_-e_ze_-e_u_+n_g_+s_dae_-e_uer
haushalt_+s_jahr	ha_u_+s_hale_-e_t_+s_jah_r
minute_+n_takt	mi_+n_u_t_+en_tae_-e_ke_-e_t
mann_+=er_chor	mä_+n_nerche_-e_oe_-e_r
aufhebung_+s_vertrag	a_u_fhebe_-e_u_+n_g_+s_ve_-e_er_te_-e_rae_-e_g
produktion_+s_stätte	pr_oe_-e_du_ke_-e_ti_o_+n_s_+s_te_-e_ätte
beruf_+s_tätigkeit	berue_-e_f_+s_t_äe_-e_ti_ge_-e_keie_-e_t
tier_heim	tierheie_-e_m
grund_gerüst	gr_unde_-e_gere_-e_ü_+s_t
spiel_runde	s_p_iee_-e_lre_-e_u_+n_de
vertrag_+s_strafe	ver_trae_-e_g_+s_strafe
tod_+es_opfer	tode_+s_oe_-e_pe_-e_fer
mikro_kosmos	mikro_ke_-e_osme_-e_oe_-e_s
jugend_herberge	jug_+en_dherberge
bio_technologie	b_i_otech_+n_ole_-e_ogie
rente_+n_versicherung	rene_-e_t_+en_ver_+s_ie_-e_chere_-e_une_-e_g
wahl_möglichkeit	wahle_-e_me_-e_öe_-e_gl_iche_-e_keie_-e_t
sommer_urlaub	s_o_me_-e_mer_ure_-e_laue_-e_b
buße_-e_geld	b_u_ße_-e_geld
bevölkerung_+s_gruppe	be_ve_-e_öe_-e_lker_u_+n_g_+s_grupe_-e_pe_-e_e
netzwerk_karte	ne_te_-e_ze_-e_we_-e_er_kke_-e_arte
kirche_+n_gemeinde	kirch_+en_gee_-e_mee_-e_i_+n_de
stadt_+=e_partnerschaft	s_t_ädtee_-e_p_ar_tner_+s_chafe_-e_t
holz_bau	h_o_lzbae_-e_u
fach_arbeiter	fac_hare_-e_bee_-e_i_ter
eis_würfel	ei_+s_w_ürfee_-e_l
schuh_werk	sc_huhe_-e_we_-e_ere_-e_k
macht_verhältnis	mache_-e_te_-e_verhe_-e_äle_-e_t_+n_ie_-e_s
dienstleistung_+s_angebot	di_+en_ste_-e_lei_+s_t_u_+n_g_+s_a_+n_gebe_-e_oe_-e_t
gewalt_+en_teilung	g_e_we_-e_ae_-e_l_t_+en_tei_le_-e_u_+n_g
speise_plan	sp_ee_-e_i_+s_ep_lan
freiheit_+s_recht	fre_ie_-e_hee_-e_i_t_+s_reche_-e_t
versicherung_+s_fall	ver_+s_ie_-e_cheru_+n_g_+s_fale_-e_l
leistung_+s_vermögen	le_i_+s_t_u_+n_g_+s_ve_-e_er_me_-e_öe_-e_gen
musik_video	mu_+s_ie_-e_ke_-e_videe_-e_o
ausbildung_+s_stelle	au_+s_be_-e_ie_-e_ldu_+n_g_+s_stele_-e_le
hund_+e_führer	hu_+n_dee_-e_fe_-e_üe_-e_hrer
mittel_punkt	mit_tel_pe_-e_u_+n_ke_-e_t
sport_schule	s_p_oe_-e_rt_+s_chue_-e_le
haus_nummer	ha_u_+s_nue_-e_me_-e_mer
unternehmen_+s_kommunikation	u_+n_ternehe_-e_m_+en_se_-e_ke_-e_oe_-e_m_mu_+n_i_kat_ie_-e_oe_-e_n
lobby_arbeit	lo_bb_ye_-e_ar_beie_-e_t
versicherung_+s_summe	ver_+s_ie_-e_cheru_+n_g_+s_sue_-e_me_-e_me_-e_e
spiel_stärke	s_p_iel_+s_te_-e_ärk_e
west_bank	w_+es_te_-e_bane_-e_k
genuss_mittel	genu_+s_se_-e_mittee_-e_l
körper_bau	kö_rp_erbae_-e_u
leben_+s_umstand	leb_+en_sue_-e_m_+s_tand
gast_+=e_buch	gä_+s_tebuch
fortbildung_+s_veranstaltung	fort_be_-e_ie_-e_ldu_+n_g_+s_ver_a_+ns_tae_-e_lte_-e_u_+n_g
grund_mauer	gr_unde_-e_me_-e_ae_-e_uer
krieg_+s_schiff	krieg_+s_schie_-e_fe_-e_f
nord_licht	no_rdle_-e_ie_-e_che_-e_t
sonne_+n_strahl	so_+n_n_+en_strahe_-e_l
aktion_+s_programm	ak_ti_o_+n_s_pe_-e_re_-e_o_grame_-e_m
kunde_+n_dienst	ku_+n_dende_-e_i_+en_se_-e_t
grat_wanderung	grae_-e_te_-e_wa_+n_dere_-e_une_-e_g
desinfektion_+s_mittel	d_+es_i_+n_fee_-e_k_te_-e_i_o_+n_s_mittee_-e_l
samstag_abend	s_a_m_+s_t_ae_-e_gae_-e_bend
fachkraft_+=e_mangel	fache_-e_ke_-e_re_-e_ä_fe_-e_tee_-e_ma_+n_gee_-e_l
bau_markt	baue_-e_me_-e_arke_-e_t
erde_-e_gas	erde_-e_gas
verwendung_+s_zweck	ver_w_+en_du_+n_g_+s_z_we_-e_ece_-e_k
winter_ruhe	wi_+n_terruhe
domain_name	d_o_me_-e_ai_+n_nae_-e_me_-e_e
erfahrung_+s_wert	e_r_fahru_+n_g_+s_we_-e_ere_-e_t
kredit_vergabe	kredie_-e_te_-e_ve_-e_er_gabe
religion_+s_unterricht	r_e_lie_-e_gi_o_+ns_u_+n_terre_-e_iche_-e_t
anschaffung_+s_kosten	a_+n_schae_-e_fe_-e_fe_-e_u_+n_g_+s_k_o_+s_ten
ton_fall	to_+n_fale_-e_l
erscheinung_+s_termin	er_+s_ce_-e_hee_-e_i_+n_u_+n_g_+s_ter_me_-e_in
bus_haltestelle	bu_+s_hae_-e_lt_+es_tele_-e_le
panik_mache	pa_+n_ie_-e_ke_-e_mache
familie_+n_unternehmen	fe_-e_a_m_ie_-e_l_i_+en_u_+n_ternehe_-e_me_-e_en
öko_system	öko_+s_y_+s_tee_-e_m
produktion_+s_standort	pr_oe_-e_du_ke_-e_ti_o_+n_s_+s_tande_-e_oe_-e_re_-e_t
kirche_-e_gemeinde	kirche_-e_gee_-e_mee_-e_i_+n_de
training_+s_programm	trae_-e_i_+n_i_+n_g_+s_pe_-e_re_-e_o_grame_-e_m
dokumentar_film	d_o_ke_-e_u_m_+en_tarfile_-e_m
bier_garten	bi_er_gare_-e_ten
schall_schutz	sc_hae_-e_le_-e_l_+s_chute_-e_z
schönheit_+s_reparatur	sc_he_-e_ö_+n_h_ei_t_+s_ree_-e_paratur
ziel_vorgabe	ziel_ve_-e_orgabe
natur_wissenschaftler	n_a_te_-e_ure_-e_w_i_+s_s_+en_schafe_-e_te_-e_ler
gast_spiel	ga_+s_t_+s_p_iee_-e_l
marke_+n_produkt	mar_k_+en_pe_-e_re_-e_oe_-e_due_-e_ke_-e_t
betreuung_+s_angebot	be_treue_-e_u_+n_g_+s_a_+n_gebe_-e_oe_-e_t
haupt_bestandteil	ha_ue_-e_pe_-e_tb_+es_tande_-e_teie_-e_l
forschung_+s_ergebnis	for_+s_che_-e_u_+n_g_+s_ere_-e_geb_+n_ie_-e_s
bund_+es_finanzminister	bu_+n_d_+es_fe_-e_i_+n_a_+n_ze_-e_me_-e_i_+n_i_+s_ter
koch_kurs	koch_kurs
wart_burg	war_tbe_-e_ure_-e_g
süd_westen	sü_de_-e_we_+s_ten
tanz_musik	ta_+n_zme_-e_u_+s_ie_-e_k
gas_pedal	ga_+s_pedae_-e_l
baum_stamm	ba_ue_-e_m_+s_tame_-e_m
partner_organisation	par_t_+n_ere_-e_oe_-e_rg_a_+n_i_+s_atie_-e_oe_-e_n
geschäft_+s_reisende	g_+es_che_-e_äe_-e_ft_+s_ree_-e_i_+s_ende
kunst_geschichte	ku_+n_se_-e_tg_+es_chichte
wasser_kocher	wa_+s_sere_-e_ke_-e_ocher
sturm_flut	st_urme_-e_fe_-e_lue_-e_t
frage_steller	fra_ge_+s_tee_-e_l_ler
luft_verkehr	lu_fte_-e_ve_-e_er_kehe_-e_r
krankheit_+s_erreger	kra_+n_ke_-e_he_i_t_+s_erree_-e_ger
bau_gewerbe	ba_ue_-e_gee_-e_werbe
ecke_-e_datum	e_c_kdatue_-e_m
spur_+en_element	s_p_urenee_-e_lee_-e_m_+en_t
grenze_-e_gebiet	gr_+en_ze_-e_gebe_-e_iet
kind_+er_heim	ki_+n_derheie_-e_m
stand_bild	s_t_andbie_-e_ld
gruppe_+n_phase	gru_pe_-e_p_+en_pe_-e_he_-e_a_+s_e
ausgang_+s_basis	au_+s_ga_+n_g_+s_ba_+s_ie_-e_s
gedanke_+n_gang	geda_+n_k_+en_ge_-e_ane_-e_g
landrat_samt	la_+n_drat_+s_ame_-e_t
curry_wurst	curre_-e_y_wur_+s_t
aufgabe_+n_gebiet	a_u_fe_-e_gab_+en_gebe_-e_iet
rhein_tal	rh_ee_-e_i_+n_tae_-e_l
gummi_bärchen	gu_m_me_-e_ib_ärc_hen
zelt_platz	zele_-e_te_-e_plate_-e_z
atem_zug	atee_-e_m_zue_-e_g
mega_pixel	meg_ae_-e_pie_-e_xee_-e_l
haken_kreuz	h_a_k_+en_ke_-e_reue_-e_z
umgang_+s_sprache	um_gane_-e_g_+s_se_-e_prache
wind_kraft	wi_+n_d_krafe_-e_t
antrag_+s_gegnerin	a_+n_trae_-e_g_+s_gee_-e_gnerie_-e_n
link_liste	li_+n_k_le_-e_i_+s_te
luft_filter	lu_fte_-e_filter
teilnahme_gebühr	te_i_l_+n_ahe_-e_megeb_üe_-e_hr
benzin_preis	benze_-e_i_+n_preie_-e_s
geschmack_+s_richtung	g_+es_che_-e_me_-e_ac_k_+s_r_ie_-e_chte_-e_une_-e_g
land_+es_verband	lande_+s_ve_-e_er_be_-e_and
projekt_leiter	pro_je_-e_ek_te_-e_lei_ter
verein_+s_leben	veree_-e_i_+ns_lee_-e_ben
sport_unterricht	s_p_oe_-e_rt_u_+n_terre_-e_iche_-e_t
erde_-e_ball	erdbale_-e_l
regierung_+s_zeit	r_e_ge_-e_iere_-e_u_+n_g_+s_zeie_-e_t
unterricht_+s_materialien	u_+n_terriche_-e_t_+s_mae_-e_tere_-e_iae_-e_l_ien
leben_+s_gefährtin	leb_+en_se_-e_gee_-e_f_ährte_-e_in
abend_essen	ab_end_+es_sen
ingenieur_büro	i_+n_g_+en_ieurbe_-e_üre_-e_o
ausgang_+s_lage	au_+s_gane_-e_g_+s_lage
amateur_funk	am_ae_-e_teure_-e_fe_-e_u_+n_k
gewalt_tat	g_e_we_-e_ae_-e_l_te_-e_tae_-e_t
sport_wette	s_p_ort_wet_te
betrieb_+s_vermögen	be_tre_-e_ieb_+s_ve_-e_er_me_-e_öe_-e_gen
vers_endung	ver_+s_endune_-e_g
standort_faktor	s_t_ande_-e_ort_fak_te_-e_oe_-e_r
büro_raum	bü_re_-e_oraue_-e_m
land_straße	la_+n_d_+s_traße
größe_+n_wahn	g_r_ö_ß_+en_wahn
lied_text	liede_-e_texe_-e_t
konjunktur_programm	ko_+n_j_u_+n_k_te_-e_ure_-e_pe_-e_re_-e_o_grame_-e_m
kreis_verwaltung	krei_+s_ve_-e_er_we_-e_ae_-e_l_te_-e_u_+n_g
pflanze_+n_teil	pf_la_+n_z_+en_teie_-e_l
tor_hüter	to_rh_üe_-e_ter
armatur_+en_brett	a_r_me_-e_ae_-e_t_urenbrete_-e_t
lauf_strecke	la_u_f_+s_trece_-e_ke_-e_e
hand_griff	ha_ndgrie_-e_fe_-e_f
bezirk_samt	b_e_ze_-e_ire_-e_k_+s_ame_-e_t
lehrer_ausbildung	lehrerae_-e_u_+s_be_-e_ie_-e_ldune_-e_g
innovation_+s_preis	i_+n_noe_-e_ve_-e_at_ie_-e_o_+ns_pe_-e_reie_-e_s
geschmack_+s_sache	g_+es_che_-e_me_-e_ac_k_+s_sache
fahrrad_tour	fa_hrradtoe_-e_ur
existenz_gründer	e_x_i_+s_t_+en_ze_-e_gre_-e_ü_+n_der
steuer_klasse	steuere_-e_kla_+s_se
gott_+es_mutter	go_tte_+s_mue_-e_t_ter
vertrag_+s_arzt	ver_trag_+s_arze_-e_t
arbeit_+s_kraft	ar_bee_-e_ie_-e_t_+s_krafe_-e_t
platz_bedarf	plae_-e_t_zbedare_-e_f
geld_beutel	ge_ldbeue_-e_tee_-e_l
integration_+s_politik	i_+n_tegrate_-e_ie_-e_o_+n_s_pe_-e_olitie_-e_k
handlung_+s_feld	ha_+n_de_-e_le_-e_u_+n_g_+s_fele_-e_d
hüfte_-e_gelenk	h_ü_ftgee_-e_l_+en_k
sommer_zeit	s_o_me_-e_mer_zeie_-e_t
tal_fahrt	te_-e_a_lfahre_-e_t
wirtschaft_+s_system	wir_t_+s_ce_-e_hae_-e_ft_+s_se_-e_y_+s_tee_-e_m
erziehung_+s_wissenschaft	e_r_ze_-e_ieh_u_+n_g_+s_w_i_+s_s_+en_schafe_-e_t
einsatz_möglichkeit	ei_+n_sate_-e_ze_-e_me_-e_öe_-e_gl_iche_-e_keie_-e_t
einsatz_bereich	ei_+n_sae_-e_te_-e_ze_-e_beree_-e_ich
koordinierung_+s_stelle	ke_-e_o_ord_i_+n_iere_-e_u_+n_g_+s_stele_-e_le
süd_küste	sü_de_-e_k_ü_+s_te
freizeit_aktivität	fre_ie_-e_zeitake_-e_ti_ve_-e_ite_-e_äe_-e_t
naturschutz_gebiet	n_a_tur_+s_che_-e_ute_-e_zgebe_-e_iet
polizei_direktion	polie_-e_zee_-e_ide_-e_ireke_-e_tie_-e_oe_-e_n
grund_stock	gr_u_+n_d_+s_te_-e_oce_-e_k
fußball_mannschaft	fu_ßbale_-e_le_-e_mann_+s_chafe_-e_t
urlaub_+s_tag	ur_laub_+s_tae_-e_g
koordinate_+n_system	ke_-e_o_ord_i_+n_a_t_+en_se_-e_y_+s_tee_-e_m
betrieb_+s_wirtschaft	be_tre_-e_ieb_+s_we_-e_ir_t_+s_chafe_-e_t
arbeit_+s_alltag	ar_bee_-e_i_t_+s_ale_-e_le_-e_tae_-e_g
qualität_+s_siegel	qua_le_-e_ie_-e_te_-e_ä_t_+s_se_-e_iegee_-e_l
fach_welt	fache_-e_we_-e_el_t
steuer_zahler	st_euere_-e_zah_ler
grund_linie	gr_undle_-e_i_+n_ie
welt_premiere	wel_te_-e_pe_-e_re_m_ie_-e_ere
industrie_anlage	i_+n_du_+s_tre_-e_ieane_-e_lage
ende_-e_gerät	ende_-e_geräe_-e_t
regen_wasser	r_e_g_+en_wa_+s_ser
grund_steuer	gr_und_+s_tee_-e_uer
stelle_+n_anzeige	st_ee_-e_l_l_+en_a_+n_zeie_-e_ge
konflikt_lösung	ko_+n_f_like_-e_te_-e_l_ö_+s_u_+n_g
studie_+n_beginn	s_t_ude_-e_i_+en_beg_inn
himmel_+s_richtung	h_i_me_-e_mel_+s_re_-e_ie_-e_chte_-e_une_-e_g
grund_problem	gr_unde_-e_pre_-e_o_be_-e_lee_-e_m
information_+s_system	i_+n_f_oe_-e_re_-e_m_at_ie_-e_o_+n_s_+s_y_+s_tee_-e_m
zeit_grund	ze_i_te_-e_grund
spiel_feld	s_p_iel_fele_-e_d
forst_haus	for_+s_te_-e_haue_-e_s
atem_schutz	at_ee_-e_m_+s_chute_-e_z
prüfung_+s_leistung	prü_fe_-e_u_+n_g_+s_lee_-e_i_+s_tune_-e_g
familie_+n_urlaub	fe_-e_a_m_ie_-e_l_i_+en_ure_-e_laue_-e_b
studie_+n_gebühr	s_t_ude_-e_i_+en_geb_üe_-e_hr
sache_-e_spende	s_a_ch_+s_p_+en_de
polizei_beamte	polie_-e_zei_bea_me_-e_te
platz_grund	plat_zgrund
leistung_+s_träger	le_i_+s_t_ung_+s_tre_-e_ä_ger
produkt_qualität	proe_-e_due_-e_ke_-e_te_-e_q_ua_le_-e_ite_-e_äe_-e_t
musik_verein	mu_+s_ie_-e_ke_-e_vereie_-e_n
ehe_bruch	eh_ebre_-e_uce_-e_h
wort_schatz	wort_+s_chate_-e_z
sache_-e_lage	sa_che_-e_lage
wasser_temperatur	wa_+s_sere_-e_tee_-e_m_peratur
