grund_kurs	grundkurs
haupt_darstellerin	hauptdar_+s_tell_+er_in
verein_+s_mitglied	v_+er_ei_+ns_mitgli_+e_d
leben_+s_welt	leb_+ens_w_+e_l_t
forst_amt	for_+s_tamt
woche_+n_stunde	woch_+ens_tunde
entwicklung_+s_zusammenarbeit	e_+n_twicklung_+s_zu_+s_ammenarb_+e_it
führung_+s_rolle	führungsrolle
schirm_herr	schirmherr
betrieb_+s_leiter	betrieb_+s_leit_+e_r
röntgen_bild	rontg_+=e_nbil_d
motor_haube	motorhaube
tourismus_verband	tourismusv_+er_ba_+n_d
handel_+s_partner	handelspartn_+e_r
rettung_+s_dienst	rettungsdie_+ns_t
arbeit_+s_schritt	arbeit_+s_schritt
versicherung_+s_vertrag	v_+er_sich_+er_ungsv_+er_trag
quant_+en_mechanik	quantenmechanik
gericht_+s_stand	g_+er_icht_+s_sta_+n_d
leben_+s_bedingung	leben_+s_bedingu_+n_g
anforderung_+s_profil	a_+n_ford_+er_ungsprofil
einnahme_quelle	einnahmequelle
einfluss_bereich	einflus_+s_b_+er_eich
bund_+es_trainer	bund_+es_trainer
web_designer	webd_+es_igner
gesundheit_+s_risiko	g_+es_u_+n_dheitsri_+s_iko
lager_halle	lag_+er_halle
zauber_wort	zaub_+er_wor_t
bund_+es_straße	bu_+n_d_+es_straße
verantwortung_+s_bereich	vera_+n_twortungsb_+er_eich
mobilfunk_anbieter	mobilfunkanbiet_+e_r
schrift_größe	schriftgröße
atom_energie	atomen_+er_gie
bibel_stelle	bibel_+s_telle
stachel_draht	stacheldraht
frage_+n_katalog	fragenkatalog
unterricht_+s_fach	unt_+er_richt_+s_fach
maschine_+n_raum	ma_+s_chin_+en_raum
bio_kraftstoff	biokraft_+s_tof_f
macht_verhältnis	machtv_+er_hältnis
wahl_vorschlag	wahlvor_+s_chlag
basis_station	ba_+s_isstation
gold_preis	goldpreis
gesundheit_+s_vorsorge	g_+es_u_+n_dheit_+s_vor_+s_orge
held_+en_tat	held_+en_tat
span_dauer	spa_+n_dauer
sicherheit_+s_standard	sich_+er_heit_+s_standar_d
fach_arbeiter	facharbeit_+e_r
seminar_raum	seminarraum
kopf_haut	kopfhaut
arbeit_+s_stelle	arbeits_+s_telle
finger_nagel	fing_+er_nag_+e_l
harn_röhre	harnröhre
betrieb_+s_ausgabe	betriebsausgabe
viertel_stunde	vi_+er_telstunde
bund_+es_anstalt	bund_+es_a_+ns_talt
wasser_masse	wa_+s_s_+er_masse
ski_fahrer	skifahrer
strahl_+en_belastung	strahlenbela_+s_tu_+n_g
ende_-e_effekt	e_+n_deffekt
weg_gefährte	weggefährte
training_+s_programm	trainingsprogram_m
fußgänger_zone	fußgang_+=e_rzo_+n_e
geld_beutel	geldbeut_+e_l
bauch_raum	bauchraum
immobilie_+n_markt	immobili_+en_markt
kosten_senkung	ko_+s_tens_+en_ku_+n_g
leistung_+s_fähigkeit	leistung_+s_fahigk_+=e_it
laser_strahl	la_+s_erstrahl
inhalt_+s_verzeichnis	i_+n_halt_+s_v_+er_zeichnis
jahr_+es_beitrag	jahr_+es_beitrag
putz_frau	putzfrau
land_+es_sprache	land_+es_sprache
unternehmen_+s_gründung	unt_+er_nehmen_+s_grü_+n_du_+n_g
forschung_+s_stelle	for_+s_chungsstelle
leben_+s_energie	lebensen_+er_gie
bund_+es_wettbewerb	bund_+es_w_+e_ttbew_+er_b
küche_+n_chef	kuch_+=e_nch_+e_f
blut_spende	blutspende
einsatz_zweck	ein_+s_atzzweck
europa_rat	europarat
beruf_+s_fachschule	b_+er_uf_+s_fachschule
leistung_+s_angebot	leistungsangebo_t
koalition_+s_partner	koalitionspartn_+e_r
bund_+es_zentrale	bund_+es_zentrale
beschäftigung_+s_verhältnis	b_+es_chäftigung_+s_v_+er_hältnis
zeit_wert	z_+e_itw_+er_t
volk_+s_wirtschaft	volk_+s_wirt_+s_chaft
spiel_wiese	spielwie_+s_e
sport_schütze	sport_+s_chütze
flug_schule	flugschule
tür_steher	tür_+s_teh_+e_r
stadt_kern	stadtkern
leistung_+s_sport	leistungssport
qualität_+s_entwicklung	qualität_+s_e_+n_twicklu_+n_g
führung_+s_treffer	fuhrungstr_+=e_ff_+e_r
handy_vertrag	handyv_+er_trag
studie_+n_richtung	studienrichtu_+n_g
heim_kino	heimki_+n_o
herkunft_+s_land	h_+er_kunft_+s_la_+n_d
blut_entnahme	blutentnahme
buch_+=er_regal	buch_+=e_rregal
fachkraft_+=e_mangel	fachkraft_+=e_mang_+e_l
garten_bau	gart_+en_bau
bau_satz	bau_+s_atz
leistung_+s_spektrum	leistungsspektru_m
gemeinde_rat	gemeind_+er_at
glaube_+ns_bekenntnis	glaub_+ens_bek_+en_ntnis
auge_+n_zwinkern	aug_+en_zwinkern
luft_verschmutzung	luftv_+er_schmutzu_+n_g
sonder_modell	sond_+er_modell
nutzung_+s_möglichkeit	nutzung_+s_moglichk_+=e_it
diesel_motor	di_+es_elmotor
wasser_fläche	wa_+s_s_+er_fläche
versicherung_+s_schutz	v_+er_sich_+er_ung_+s_schut_z
kirche_+n_geschichte	kirch_+en_g_+es_chichte
quant_+en_sprung	quantenspru_+n_g
dienst_herr	die_+ns_therr
gen_technik	gentechnik
regel_schule	regelschule
haft_pflicht	haftpflicht
pfarre_-e_kirche	pfarrkirche
cent_rum	ce_+n_tru_m
werk_tag	w_+er_ktag
jugend_zentrum	jug_+en_dz_+en_tru_m
zuschauer_zahl	zu_+s_chau_+er_zahl
übergang_+s_regelung	ub_+=e_rgangsregelu_+n_g
sommer_wetter	somm_+er_w_+e_tt_+e_r
charakter_zug	charakt_+er_zug
lärm_belästigung	larmb_+=e_lä_+s_tigu_+n_g
universität_+s_klinikum	u_+n_iv_+er_sität_+s_klinikum
vorbereitung_+s_zeit	vorb_+er_eitung_+s_z_+e_i_t
preis_unterschied	preisunt_+er_schi_+e_d
spur_+en_suche	spuren_+s_uche
emission_+s_handel	emi_+s_sio_+ns_hand_+e_l
wasser_kraftwerk	wa_+s_s_+er_kraftw_+er_k
aufenthalt_+s_erlaubnis	auf_+en_thalts_+er_laubnis
haupt_verhandlung	hauptv_+er_handlu_+n_g
kampf_flugzeug	kampfflugzeug
bau_arbeit	bauarb_+e_it
bügel_eisen	bug_+=e_leis_+e_n
wahl_gang	wahlga_+n_g
leben_+s_werk	leb_+ens_w_+er_k
über_angebot	ub_+=e_rangebo_t
aufgabe_+n_bereich	aufgabenb_+er_eich
klasse_+n_zimmer	klas_+s_enzimm_+e_r
kraft_training	krafttraini_+n_g
strategie_spiel	strategi_+es_pi_+e_l
spiel_abschnitt	spielab_+s_chnitt
april_scherz	april_+s_ch_+er_z
haushalt_+s_führung	hau_+s_halt_+s_führu_+n_g
amt_+s_sprache	amts_+s_prache
geburtstag_+s_kind	geburt_+s_tag_+s_ki_+n_d
wirtschaft_+s_wissenschaft	wirt_+s_chaft_+s_wis_+s_e_+ns_chaft
strom_konzern	stromkonz_+er_n
schrift_führerin	schriftfuhr_+=e_rin
ehe_partner	ehepartn_+e_r
zweck_verband	zweckv_+er_ba_+n_d
winter_sport	wint_+er_sport
lage_plan	lageplan
schwere_grad	schw_+er_egrad
kunde_+n_betreuung	kundenbetreuu_+n_g
beruf_+s_ausübung	b_+er_ufsausübu_+n_g
meister_prüfung	mei_+s_t_+er_prüfu_+n_g
qualität_+s_standard	qualität_+s_standar_d
urlaub_+s_region	urlaubsregion
körper_größe	korp_+=e_rgröße
sicherheit_+s_technik	sich_+er_heit_+s_technik
meinung_+s_äußerung	meinung_+s_auß_+=e_ru_+n_g
feuerwerk_+s_körper	feu_+er_w_+er_kskorp_+=e_r
haupt_sponsor	haupt_+s_pon_+s_or
raum_klima	raumklima
bund_+es_land	bund_+es_la_+n_d
kopf_schütteln	kopf_+s_chutt_+=e_ln
seife_+n_blase	seif_+en_blase
pflege_dienst	pflegedie_+ns_t
abend_programm	abendprogram_m
liebling_+s_buch	liebling_+s_buch
produkt_qualität	produktqualität
not_lage	notlage
luft_verkehr	luftv_+er_kehr
energie_technik	en_+er_gietechnik
ton_studio	ton_+s_tudio
armatur_+en_brett	armatur_+en_brett
zylinder_kopf	zylind_+er_kopf
bildung_+s_zentrum	bildung_+s_zentru_m
straße_+n_seite	straßen_+s_eite
sicht_weise	sichtwei_+s_e
ton_art	tonart
treppe_+n_haus	trepp_+en_haus
spende_+n_aktion	spendenaktion
hotel_gast	hotelga_+s_t
kind_+er_erziehung	kind_+er_erziehu_+n_g
liebe_+s_beziehung	lieb_+es_beziehu_+n_g
verwaltung_+s_kosten	verwaltungsko_+s_t_+e_n
schwein_steiger	schweinsteiger
telefon_anlage	telefonanlage
arbeiter_klasse	arbeit_+er_klasse
brief_umschlag	briefum_+s_chlag
erfolg_+s_aussicht	erfolgsaus_+s_icht
kaiser_zeit	kaiserz_+e_i_t
leben_+s_gefährtin	leben_+s_g_+e_fährtin
gesundheit_+s_förderung	g_+es_u_+n_dheitsford_+=e_ru_+n_g
pflege_personal	pflegep_+er_sonal
grund_ordnung	grundordnu_+n_g
fuß_sohle	fuß_+s_ohle
gruppe_+n_arbeit	gruppenarb_+e_it
schuld_gefühl	schuldgefühl
land_+es_anstalt	land_+es_a_+ns_talt
inhalt_+s_stoff	i_+n_halt_+s_stof_f
einkauf_+s_zentrum	einkauf_+s_zentru_m
spitze_+n_platz	spitzenplat_z
agrar_politik	agrarpolitik
stil_mittel	stilmitt_+e_l
blog_eintrag	blogeintrag
glas_scheibe	gla_+s_scheibe
strom_anschluss	stroman_+s_chluss
wärme_verlust	warm_+=e_v_+er_lu_+s_t
grafik_karte	grafikkarte
steuer_bescheid	steu_+er_b_+es_ch_+e_id
feuerwehr_mann	feu_+er_wehrma_+n_n
arbeiter_bewegung	arbeit_+er_bewegu_+n_g
landschaft_+s_bild	land_+s_chaft_+s_bil_d
stadt_rat	stadtrat
link_sammlung	link_+s_ammlu_+n_g
chor_leiter	chorleit_+e_r
kommunikation_+s_system	kommunikations_+s_y_+s_t_+e_m
bericht_erstatter	b_+er_icht_+er_statt_+e_r
reparatur_kosten	reparaturko_+s_t_+e_n
vertrag_+s_partei	vertragspart_+e_i
gespräch_+s_thema	ge_+s_präch_+s_th_+e_ma
polizei_einsatz	polizeiein_+s_atz
fahrrad_tour	fahrradtour
welle_+n_sittich	wellen_+s_ittich
kraft_fahrer	kraftfahrer
film_material	filmmat_+er_ial
katastrophe_+n_schutz	kata_+s_troph_+ens_chut_z
kirche_+n_schiff	kirchen_+s_chiff
kirche_-e_spiel	kirchspi_+e_l
ort_+s_bürgermeister	ortsburg_+=e_rmei_+s_t_+e_r
wasser_versorgung	wa_+s_serv_+er_sorgu_+n_g
wein_keller	weinkell_+e_r
erwerb_+s_arbeit	erw_+er_b_+s_arb_+e_it
projekt_leitung	projektleitu_+n_g
akte_+n_einsicht	aktenei_+ns_icht
wunder_mittel	wund_+er_mitt_+e_l
tanz_schule	tanzschule
team_geist	teamgei_+s_t
praxis_erfahrung	praxi_+s_erfahru_+n_g
kurs_ziel	kur_+s_zi_+e_l
arsch_loch	ar_+s_chloch
über_see	üb_+er_see
kenntnis_stand	k_+en_ntnissta_+n_d
größe_+n_ordnung	groß_+=e_nordnu_+n_g
verkehr_+s_mittel	verkehr_+s_mitt_+e_l
garten_haus	gartenhaus
problem_feld	problemfel_d
fach_buch	fachbuch
folge_schaden	folg_+es_chad_+e_n
reihe_+n_haus	reih_+en_haus
burg_anlage	burganlage
beruf_+s_ausbildung	b_+er_ufsausbildu_+n_g
leistung_+s_stand	leistungssta_+n_d
elektro_gerät	elektrog_+er_ät
haushalt_+s_lage	hau_+s_halt_+s_lage
spiel_klasse	spielklasse
not_aufnahme	notaufnahme
ausbildung_+s_vertrag	au_+s_bildungsv_+er_trag
bund_+es_innenminister	bund_+es_inn_+en_mini_+s_t_+e_r
pop_musik	popmu_+s_ik
jahr_+es_umsatz	jahr_+es_um_+s_atz
steuer_einnahme	steu_+er_einnahme
sport_gerät	sportg_+er_ät
telefon_anschluss	telefonanschluss
tempel_anlage	tempelanlage
team_leiter	teamleit_+e_r
wasser_verbrauch	wa_+s_serv_+er_brauch
anwendung_+s_möglichkeit	a_+n_wendung_+s_moglichk_+=e_it
berg_steiger	bergsteiger
sache_-e_kenntnis	sachk_+en_ntnis
wetter_station	wett_+er_station
hausrat_versicherung	hau_+s_ratv_+er_sich_+er_u_+n_g
wald_rand	waldra_+n_d
stand_heizung	sta_+n_dheizu_+n_g
handel_+s_unternehmen	handel_+s_unt_+er_nehm_+e_n
ordnung_samt	ordnung_+s_amt
versicherung_+s_gesellschaft	v_+er_sich_+er_ungsg_+es_ellschaft
alkohol_gehalt	alkoholgehalt
umgang_+s_sprache	umgangssprache
kern_bereich	k_+er_nb_+er_eich
macht_haber	machthab_+e_r
bund_+es_vorstand	bund_+es_vor_+s_ta_+n_d
schwieger_sohn	schwieg_+er_sohn
maschine_+n_gewehr	ma_+s_chinengew_+e_hr
beschwerde_verfahren	b_+es_chw_+er_dev_+er_fahr_+e_n
sonne_+n_schirm	sonn_+ens_chirm
betrieb_+s_rat	betrieb_+s_rat
farbe_-e_ton	farbton
angst_zustand	ang_+s_tzu_+s_ta_+n_d
rettung_+s_paket	rettung_+s_pak_+e_t
partner_schule	partn_+er_schule
bau_unternehmer	bauunt_+er_nehm_+e_r
über_einkunft	ub_+=e_reinkunft
leben_+s_abschnitt	leb_+ens_abschnitt
schrift_führer	schriftfuhr_+=e_r
hund_+e_rasse	hund_+er_asse
auftrag_+s_vergabe	auftrag_+s_v_+er_gabe
finanz_ausgleich	fina_+n_zau_+s_gleich
wasser_tropfen	wa_+s_s_+er_tropf_+e_n
haus_mittel	hau_+s_mitt_+e_l
straße_+n_bau	straß_+en_bau
lebensmittel_sicherheit	leb_+ens_mittel_+s_ich_+er_h_+e_it
bild_qualität	bildqualität
umgang_+s_ton	umgang_+s_ton
meer_wasser	m_+eer_was_+s_er
ruhr_pott	ruhrpott
uhr_werk	uhrw_+er_k
garten_anlage	gartenanlage
text_stelle	t_+e_xt_+s_telle
homo_phobie	homophobie
fach_gebiet	fachgebi_+e_t
strecke_+n_abschnitt	streck_+en_ab_+s_chnitt
aussicht_+s_punkt	au_+s_sicht_+s_punkt
wasser_pumpe	wa_+s_s_+er_pumpe
meer_+es_spiegel	m_+eer_esspieg_+e_l
sonder_aktion	sond_+er_aktion
herr_+en_mannschaft	h_+er_r_+en_mann_+s_chaft
name_+ns_geber	namen_+s_geb_+e_r
anlage_form	anlagefor_m
land_wirt	la_+n_dwir_t
seil_bahn	seilbahn
reise_zeit	reisez_+e_i_t
seite_+n_straße	seit_+ens_traße
arbeit_+s_alltag	arbeitsalltag
werk_vertrag	w_+er_kv_+er_trag
geschäft_+s_führung	g_+es_chäft_+s_führu_+n_g
treff_punkt	treffpunkt
haupt_fach	hauptfach
auto_unfall	autounfall
preis_trägerin	prei_+s_trag_+=e_rin
aktie_+n_markt	akti_+en_markt
seminar_teilnehmer	seminarteilnehm_+e_r
verbesserung_+s_vorschlag	verb_+es_s_+er_ung_+s_vor_+s_chlag
leben_+s_gefahr	leben_+s_gefahr
information_+s_fluss	information_+s_fluss
ausland_+s_aufenthalt	au_+s_land_+s_auf_+en_thalt
schatz_kammer	schatzkamm_+e_r
verein_+s_register	v_+er_einsregi_+s_t_+e_r
sekundar_schule	seku_+n_dar_+s_chule
information_+s_dienst	informatio_+ns_die_+ns_t
see_meile	seemeile
grundstück_+s_eigentümer	grund_+s_tucks_+=e_igentum_+=e_r
klima_veränderung	klimav_+er_and_+=e_ru_+n_g
umwelt_zone	umweltzo_+n_e
vorgehen_+s_weise	vorgeh_+ens_wei_+s_e
boden_belag	bodenbelag
stadt_archiv	stadtarchi_v
mail_server	mails_+er_v_+e_r
muster_beispiel	mu_+s_t_+er_beispi_+e_l
titel_seite	titel_+s_eite
grund_stein	grund_+s_tein
kilo_watt	kilowat_t
ost_seite	ost_+s_eite
sonne_+n_finsternis	sonn_+en_fin_+s_t_+er_nis
film_+e_macher	filmemacher
chef_trainer	cheftrainer
sport_abzeichen	sportabzeich_+e_n
schaden_+s_ersatz	schadens_+er_satz
mutter_sprachler	mutt_+er_sprachler
bund_+es_amt	bu_+n_d_+es_amt
forst_haus	for_+s_thaus
ware_+n_test	warente_+s_t
pharma_industrie	pharmaindu_+s_trie
wald_gebiet	waldgebi_+e_t
bachelor_studiengang	bachelor_+s_tudi_+en_ga_+n_g
probe_zeit	probez_+e_i_t
mensch_+en_hand	m_+en_sch_+en_ha_+n_d
schule_-e_gebäude	schulgebäude
transport_weg	tra_+ns_portw_+e_g
grundlage_+n_forschung	grundlag_+en_for_+s_chu_+n_g
navigation_+s_system	navigations_+s_y_+s_t_+e_m
tor_schütze	tor_+s_chütze
zeit_not	zeitnot
konflikt_situation	konflikt_+s_ituation
wort_sinn	wort_+s_i_+n_n
licht_bild	lichtbil_d
leben_+s_verhältnis	leb_+ens_v_+er_hältnis
elektro_auto	elektroauto
auge_+n_lid	aug_+en_lid
information_+s_stand	information_+s_sta_+n_d
kultur_programm	kulturprogram_m
leben_+s_weg	leb_+ens_w_+e_g
spiel_betrieb	spielbetri_+e_b
elektro_technik	elektrotechnik
kultur_raum	kulturraum
bau_teil	bauteil
pflicht_verletzung	pflichtv_+er_letzu_+n_g
fußball_spiel	fußball_+s_pi_+e_l
anführung_+s_zeichen	a_+n_führung_+s_zeich_+e_n
zukunft_+s_perspektive	zuku_+n_ftsp_+er_spektive
produktion_+s_stätte	produktion_+s_stätte
alter_+s_stufe	alt_+er_sstufe
lauf_schuh	lauf_+s_chuh
spitz_name	spitzname
krieg_+s_jahr	krieg_+s_jahr
hals_band	hal_+s_ba_+n_d
sonder_zeichen	sond_+er_zeich_+e_n
luft_ballon	luftballon
kind_+er_arzt	kind_+er_arzt
film_preis	filmpreis
sport_stätte	sport_+s_tätte
strafe_-e_anzeige	strafanzeige
konzert_saal	konz_+er_t_+s_aal
nutzung_+s_dauer	nutzung_+s_dauer
wasser_dampf	wa_+s_s_+er_damp_f
meinung_+s_bildung	meinung_+s_bildu_+n_g
land_bau	la_+n_dbau
lauf_leistung	lauflei_+s_tu_+n_g
auto_motiv	automoti_v
untersuchung_+s_methode	unt_+er_suchung_+s_methode
spiel_gemeinschaft	spielgemeinschaft
qualität_+s_merkmal	qualität_+s_m_+er_kmal
flug_blatt	flugblatt
teil_projekt	teilprojekt
kugel_lager	kugellager
leistung_+s_kurs	leistungskurs
ausschuss_mitglied	au_+s_schus_+s_mitgli_+e_d
frage_zeichen	fragezeich_+e_n
durchschnitt_+s_alter	durchschnitt_+s_alt_+e_r
kredit_institut	kreditin_+s_titut
kunde_+n_service	kunden_+s_ervice
fuß_stapfen	fußstapf_+e_n
internet_präsenz	int_+er_netprä_+s_e_+n_z
winter_reifen	wint_+er_reif_+e_n
fan_gemeinde	fangemeinde
volk_+s_zählung	volk_+s_zählu_+n_g
titel_bild	titelbil_d
kern_punkt	kernpunkt
pfarre_-e_gemeinderat	pfarrgemeind_+er_at
münster_land	mün_+s_t_+er_la_+n_d
schule_-e_bildung	schulbildu_+n_g
körper_gefühl	korp_+=e_rgefühl
kreis_gebiet	krei_+s_gebi_+e_t
zeit_abstand	zeitab_+s_ta_+n_d
haupt_anliegen	hauptanlieg_+e_n
backe_+n_zahn	back_+en_zahn
geschäft_+s_tätigkeit	g_+es_chäft_+s_tatigk_+=e_it
sonder_form	sond_+er_for_m
trieb_wagen	triebwagen
kind_+er_programm	kind_+er_program_m
unternehmen_+s_führung	unt_+er_nehmen_+s_führu_+n_g
bild_rand	bildra_+n_d
konzentration_+s_lager	konzentration_+s_lager
ansatz_punkt	a_+ns_atzpunkt
bahn_strecke	bahnstrecke
mikro_kosmos	mikroko_+s_mos
klasse_+n_lehrer	klas_+s_enlehrer
religion_+s_gemeinschaft	religionsgemeinschaft
jahr_+es_zeit	jahr_+es_z_+e_i_t
samstag_morgen	sam_+s_tagmorg_+e_n
lippe_+n_stift	lipp_+ens_tift
frage_steller	frag_+es_tell_+e_r
kind_+er_spiel	kind_+er_spi_+e_l
börse_+n_gang	bör_+s_e_+n_ga_+n_g
gast_familie	ga_+s_tfamilie
strom_leitung	stromleitu_+n_g
pension_+s_kasse	pensio_+ns_kasse
rauch_verbot	rauchv_+er_bo_t
blut_probe	blutprobe
kunst_museum	kun_+s_tmu_+s_eum
meile_+n_stein	meil_+en_st_+e_in
licht_strahl	licht_+s_trahl
stadt_+=e_tag	stadt_+=e_tag
heim_sieg	heim_+s_i_+e_g
kind_+er_gruppe	kind_+er_gruppe
christ_kind	chri_+s_tki_+n_d
erfahrung_+s_schatz	erfahrung_+s_schat_z
ehe_leute	eheleute
energie_verbrauch	en_+er_giev_+er_brauch
bezirk_+s_verband	b_+e_zirksv_+er_ba_+n_d
bund_+es_versammlung	bund_+es_v_+er_sammlu_+n_g
ermittlung_+s_verfahren	ermittlungsv_+er_fahr_+e_n
konsum_gut	kon_+s_umgut
herz_frequenz	h_+er_zfrequ_+en_z
industrie_unternehmen	indu_+s_trieunt_+er_nehm_+e_n
start_loch	startloch
büro_raum	büroraum
wohnung_+s_eigentümer	wohnungseigentum_+=e_r
as_sang	as_+s_a_+n_g
zug_fahrt	zugfahrt
information_+s_verarbeitung	information_+s_v_+er_arbeitu_+n_g
oper_+n_haus	op_+er_nhaus
denkmal_schutz	d_+en_kmal_+s_chut_z
atom_müll	atommüll
ruhe_stätte	ruh_+es_tätte
stress_situation	str_+es_ssituation
sport_zentrum	sportz_+en_tru_m
grund_wasser	gru_+n_dwa_+s_s_+e_r
spur_+en_element	spur_+en_elem_+en_t
oberst_leutnant	ob_+er_stleutna_+n_t
familie_+n_betrieb	familienbetri_+e_b
wort_wahl	wortwahl
rechen_zentrum	rech_+en_zentru_m
arbeit_+s_bereich	arbeit_+s_b_+er_eich
auto_gas	autogas
sport_schule	sportschule
reinigung_+s_mittel	reinigung_+s_mitt_+e_l
bund_+es_ministerin	bund_+es_minist_+er_in
gold_fisch	goldfi_+s_ch
netzwerk_karte	n_+e_tzw_+er_kkarte
bank_note	bank_+n_ote
land_+es_hauptstadt	land_+es_haupt_+s_tadt
schlag_abtausch	schlagabtau_+s_ch
park_anlage	parkanlage
dorf_gemeinschaft	dorfgemeinschaft
chance_+n_verwertung	chancenv_+er_w_+er_tu_+n_g
land_+es_grenze	land_+es_grenze
masse_+n_medium	ma_+s_senmediu_m
deck_mantel	d_+e_ckmant_+e_l
zeit_lupe	zeitlupe
bund_+es_recht	bund_+es_r_+e_cht
fahrt_zeit	fahrtz_+e_i_t
hochwasser_schutz	hochwa_+s_s_+er_schut_z
bus_fahrt	bu_+s_fahrt
gruppe_+n_mitglied	grupp_+en_mitgli_+e_d
zeit_mangel	z_+e_itmang_+e_l
ansicht_+s_sache	a_+ns_icht_+s_sache
haupt_eingang	haupteinga_+n_g
bar_geld	barg_+e_ld
leben_+s_dauer	leb_+ens_dauer
grund_stock	grund_+s_tock
haar_ausfall	haarau_+s_fall
ausgang_+s_basis	au_+s_gangsba_+s_is
kunst_akademie	kun_+s_takademie
wasser_hahn	wa_+s_s_+er_hahn
anfang_+s_phase	a_+n_fangsphase
tat_ort	tatort
rand_bereich	randb_+er_eich
energie_beratung	en_+er_gieb_+er_atu_+n_g
steuer_zahler	steu_+er_zahler
nord_west	nordw_+es_t
therapie_form	th_+er_apiefor_m
flut_licht	flutlicht
haupt_rolle	hauptrolle
chemo_therapie	chemoth_+er_apie
auto_industrie	autoindu_+s_trie
tor_chance	torchance
transport_mittel	tra_+ns_portmitt_+e_l
auge_+n_winkel	aug_+en_wink_+e_l
bronze_medaille	bronzemedaille
krankheit_+s_erreger	krankheits_+er_reg_+e_r
geltung_+s_bereich	geltungsb_+er_eich
abschluss_prüfung	ab_+s_chlussprüfu_+n_g
task_leiste	ta_+s_klei_+s_te
garten_arbeit	gartenarb_+e_it
arbeit_+s_stätte	arbeit_+s_stätte
schule_-e_system	schul_+s_y_+s_t_+e_m
platz_grund	platzgru_+n_d
reise_route	rei_+s_eroute
page_rank	pag_+er_a_+n_k
verkehr_+s_betrieb	verkehrsbetri_+e_b
land_+es_meisterschaft	land_+es_mei_+s_t_+er_schaft
schicksal_+s_schlag	schicksals_+s_chlag
arbeit_+s_zeugnis	arbeit_+s_zeugnis
messe_stand	m_+es_s_+es_ta_+n_d
lobby_arbeit	lobbyarb_+e_it
stelle_+n_anzeige	stellenanzeige
aktion_+s_bündnis	aktionsbündnis
projekt_leiterin	projektleit_+er_in
lied_+er_macher	lied_+er_macher
gast_wirtschaft	ga_+s_twirt_+s_chaft
ecke_-e_punkt	eckpunkt
versicherung_+s_pflicht	v_+er_sich_+er_ung_+s_pflicht
planung_+s_phase	planungsphase
fach_gruppe	fachgruppe
liebling_+s_film	liebling_+s_fil_m
muskel_aufbau	mu_+s_kelaufbau
geräusch_kulisse	geräu_+s_chkulisse
sommer_tag	somm_+er_tag
art_genosse	artg_+en_osse
elektro_smog	elektro_+s_mog
wunder_land	wund_+er_la_+n_d
naturschutz_gebiet	natur_+s_chutzgebi_+e_t
vertrag_+s_bedingung	vertrag_+s_bedingu_+n_g
schlacht_hof	schlachthof
drehzahl_bereich	drehzahlb_+er_eich
stadt_haus	stadthaus
holz_bau	holzbau
abend_brot	abe_+n_dbrot
antrag_stellung	antragstellu_+n_g
gewinn_spiel	g_+e_winnspi_+e_l
stadt_staat	stadt_+s_taat
volk_+s_mund	volk_+s_mu_+n_d
herz_insuffizienz	h_+er_zin_+s_uffizi_+en_z
spiel_stein	spiel_+s_tein
stadt_bibliothek	stadtbiblioth_+e_k
ferien_wohnung	feri_+en_wohnu_+n_g
wohlfahrt_+s_verband	wohlfahrt_+s_v_+er_ba_+n_d
nagel_lack	nagellack
gemeinde_vertretung	gemeindev_+er_tretu_+n_g
olympia_stadion	olympia_+s_tadion
land_+es_meister	land_+es_mei_+s_t_+e_r
schule_-e_haus	schulhaus
ecke_-e_ball	eckball
buch_form	buchfor_m
rücken_problem	ruck_+=e_nprobl_+e_m
tier_halter	ti_+er_halt_+e_r
nacht_himmel	nachthimm_+e_l
stimme_-e_abgabe	stimmabgabe
familie_+n_feier	familienfei_+e_r
ferien_zeit	feri_+en_z_+e_i_t
bus_linie	bu_+s_linie
zeit_abschnitt	zeitab_+s_chnitt
leben_+s_gestaltung	leb_+ens_g_+es_taltu_+n_g
grund_linie	grundlinie
betrieb_+s_wirtschaft	betriebswirt_+s_chaft
haut_krebs	hautkrebs
zweifel_+s_fall	zweifel_+s_fall
haupt_ziel	hauptzi_+e_l
beratung_+s_gespräch	b_+er_atungsg_+es_präc_h
urlaub_+s_zeit	urlaub_+s_z_+e_i_t
bild_zeitung	bildzeitu_+n_g
schüler_zeitung	schul_+=e_rzeitu_+n_g
erwerb_+s_leben	erw_+er_b_+s_leb_+e_n
video_sequenz	videosequ_+en_z
freiheit_+s_recht	freiheit_+s_recht
infektion_+s_krankheit	infektion_+s_krankh_+e_it
frau_+en_fußball	frauenfußball
dach_fläche	dachfläche
benutzer_name	b_+en_utz_+er_name
bürger_verein	burg_+=e_rv_+er_ein
bau_abschnitt	bauab_+s_chnitt
studie_+n_angebot	studienangebo_t
projekt_woche	projektwoche
kartei_karte	karteikarte
tor_hüter	torhut_+=e_r
arbeit_+s_weise	arbeit_+s_wei_+s_e
punkt_zahl	punktzahl
ferien_haus	feri_+en_haus
fenster_heber	f_+en_st_+er_heb_+e_r
braut_kleid	brautkleid
schule_-e_abgänger	schulabgang_+=e_r
stroh_halm	strohhal_m
bund_+es_ausschuss	bund_+es_aus_+s_chuss
ohr_wurm	ohrwur_m
markt_teilnehmer	marktteilnehm_+e_r
alexander_platz	alexand_+er_plat_z
blut_test	blutt_+es_t
hanse_stadt	han_+s_e_+s_tadt
zahn_riemen	zahnri_+e_m_+e_n
mittel_punkt	mittelpunkt
arbeit_+s_ort	arbeit_+s_ort
tag_+es_zeit	tag_+es_z_+e_i_t
saar_land	saarla_+n_d
straße_+n_rand	straßenra_+n_d
universität_+s_bibliothek	u_+n_iv_+er_sität_+s_biblioth_+e_k
spaten_stich	spat_+ens_tich
bach_lauf	bachlauf
nord_seite	nord_+s_eite
olive_+n_öl	olive_+n_öl
immobilie_+n_fonds	immobili_+en_fonds
buch_druck	buchdruck
haushalt_+s_mittel	hau_+s_halt_+s_mitt_+e_l
pflege_fall	pflegefall
ausbildung_+s_platz	au_+s_bildung_+s_plat_z
jahr_markt	jahrmarkt
einsatz_stelle	ein_+s_atz_+s_telle
presse_information	pr_+es_seinformation
handel_+s_vertreter	handelsv_+er_tret_+e_r
montag_abend	montagab_+en_d
straße_+n_netz	straßenn_+e_tz
beratung_+s_unternehmen	b_+er_atungsunt_+er_nehm_+e_n
regierung_+s_organisation	regi_+er_ungsorganisation
hand_fläche	handfläche
kaiser_reich	kais_+er_reich
rauch_melder	rauchmeld_+e_r
plastik_tüte	plastiktüte
kultur_geschichte	kulturg_+es_chichte
telefon_leitung	telefonleitu_+n_g
preis_senkung	preiss_+en_ku_+n_g
haupt_seite	haupt_+s_eite
finanz_dienstleistung	fina_+n_zdi_+ens_tlei_+s_tu_+n_g
pflege_stelle	pfleg_+es_telle
spiel_halle	spielhalle
angriff_+s_krieg	angriff_+s_kri_+e_g
info_stand	i_+n_fo_+s_ta_+n_d
zugriff_+s_recht	zugriff_+s_recht
ruhe_zustand	ruhezusta_+n_d
bau_leistung	baulei_+s_tu_+n_g
bundesliga_spiel	bund_+es_liga_+s_pi_+e_l
betrieb_+s_kosten	betriebsko_+s_t_+e_n
stunde_+n_lohn	stundenlohn
kreis_verband	kreisv_+er_ba_+n_d
fach_presse	fachpr_+es_se
luft_raum	luftraum
eröffnung_+s_feier	eröffnung_+s_fei_+e_r
recht_anwalt	rechta_+n_wal_t
kosten_aufwand	ko_+s_tenaufwa_+n_d
beruf_+s_praxis	b_+er_ufspraxis
herstellung_+s_kosten	h_+er_stellungsko_+s_t_+e_n
industrie_zweig	indu_+s_triezweig
schatten_seite	schatten_+s_eite
bauch_schmerz	bauch_+s_chm_+er_z
katze_+n_klo	katzenklo
land_+es_zentrale	land_+es_zentrale
kreis_verkehr	kreisv_+er_kehr
magnet_feld	magnetf_+e_l_d
kind_+er_arbeit	kind_+er_arb_+e_it
bahn_linie	bahnlinie
gericht_+s_urteil	g_+er_icht_+s_urt_+e_il
kleid_+er_schrank	kleid_+er_schra_+n_k
konservierung_+s_stoff	kon_+s_ervi_+er_ung_+s_stof_f
gesellschaft_+s_recht	g_+es_ellschaft_+s_recht
pflicht_spiel	pflicht_+s_pi_+e_l
ost_block	o_+s_tblock
sport_platz	sportplat_z
wirtschaft_+s_faktor	wirt_+s_chaft_+s_faktor
haftung_+s_ausschluss	haftungsaus_+s_chluss
studie_+n_beginn	studienbegi_+n_n
mutter_milch	mutt_+er_milch
fisch_fang	fi_+s_chfa_+n_g
bau_land	baula_+n_d
stau_damm	staudam_m
tier_quälerei	tierqual_+=e_r_+e_i
akte_+n_zeichen	aktenzeich_+e_n
arbeit_+s_vertrag	arbeitsv_+er_trag
abstieg_+s_platz	ab_+s_tieg_+s_plat_z
ende_-e_spiel	endspi_+e_l
verkauf_+s_zahl	v_+er_kauf_+s_zahl
grund_problem	grundprobl_+e_m
steuer_erklärung	steu_+er_erkläru_+n_g
link_liste	linkli_+s_te
master_plan	ma_+s_t_+er_plan
siedlung_+s_gebiet	siedlungsgebi_+e_t
fitness_studio	fitn_+es_s_+s_tudio
fraktion_+s_chef	fraktio_+ns_ch_+e_f
klasse_+n_stufe	klass_+ens_tufe
natur_produkt	naturprodukt
finanz_verwaltung	fina_+n_zv_+er_waltu_+n_g
vernichtung_+s_lager	v_+er_nichtungslager
musik_industrie	mu_+s_ikindu_+s_trie
zusatz_information	zu_+s_atzinformation
wirtschaft_+s_forschung	wirt_+s_chaft_+s_for_+s_chu_+n_g
forschung_+s_einrichtung	for_+s_chungseinrichtu_+n_g
schornstein_feger	schorn_+s_teinfeg_+e_r
kirche_+n_jahr	kirch_+en_jahr
leben_+s_jahr	leb_+ens_jahr
name_+ns_änderung	namen_+s_and_+=e_ru_+n_g
sport_park	sportpark
seite_+n_teil	seitent_+e_il
ausländer_behörde	au_+s_land_+=e_rbehörde
posaune_+n_chor	po_+s_aun_+en_chor
lauf_strecke	laufstrecke
haus_ordnung	hau_+s_ordnu_+n_g
prüfung_+s_leistung	prufungsl_+=e_i_+s_tu_+n_g
gruppe_+n_foto	grupp_+en_foto
bearbeitung_+s_gebühr	bearbeitungsgebühr
heilung_+s_prozess	heilungsprozess
verkauf_+s_fläche	v_+er_kauf_+s_fläche
rast_platz	ra_+s_tplat_z
diskussion_+s_rund	di_+s_kussionsru_+n_d
bau_jahr	baujahr
löwe_+n_zahn	low_+=e_nzahn
werbung_+s_kosten	werbungsko_+s_t_+e_n
presse_konferenz	pr_+es_sekonf_+er_e_+n_z
streit_fall	streitfall
aufbruch_stimmung	aufbruch_+s_timmu_+n_g
kind_+er_krippe	kind_+er_krippe
grat_wanderung	gratwand_+er_u_+n_g
speicher_platz	speich_+er_plat_z
krebs_zelle	kreb_+s_zelle
durst_strecke	dur_+s_tstrecke
kurs_angebot	kursangebo_t
frau_+en_kirche	frau_+en_kirche
ort_+s_beirat	ort_+s_beirat
ei_gelb	eig_+e_lb
familie_+n_name	familien_+n_ame
ende_-e_runde	e_+n_drunde
aufgabe_+n_stellung	aufgaben_+s_tellu_+n_g
staat_+s_chef	staat_+s_ch_+e_f
zusatz_kosten	zu_+s_atzko_+s_t_+e_n
teil_aspekt	teila_+s_pekt
datei_system	datei_+s_y_+s_t_+e_m
gast_beitrag	ga_+s_tbeitrag
pflege_versicherung	pflegev_+er_sich_+er_u_+n_g
rate_+n_zahlung	rat_+en_zahlu_+n_g
luft_linie	luftlinie
gewicht_+s_abnahme	g_+e_wicht_+s_abnahme
versorgung_+s_ausgleich	v_+er_sorgungsausgleich
berg_leute	b_+er_gleute
haus_meister	hau_+s_mei_+s_t_+e_r
tumor_zelle	tumorzelle
kredit_nehmer	kreditnehm_+e_r
krieg_+s_ende	krieg_+s_ende
energie_effizienz	en_+er_gi_+ee_ffizi_+en_z
kredit_vergabe	kreditv_+er_gabe
sicherheit_+s_politik	sich_+er_heitspolitik
telefon_zelle	telefonzelle
kontakt_formular	kontaktformular
gewalt_täter	g_+e_walttat_+=e_r
geld_geber	geldgeb_+e_r
finanz_sektor	finanz_+s_ektor
staub_sauger	staubsauger
bio_technologie	biotechnologie
gewicht_+s_verlust	g_+e_wicht_+s_v_+er_lu_+s_t
wirtschaft_+s_lage	wirt_+s_chaft_+s_lage
mineral_stoff	min_+er_al_+s_tof_f
klang_farbe	klangfarbe
sonder_stellung	sond_+er_stellu_+n_g
grill_platz	grillplat_z
erfolg_+s_modell	erfolg_+s_modell
mobilfunk_netz	mobilfunkn_+e_tz
winde_seil	wind_+es_eil
grund_gedanke	grundgedanke
verteidigung_+s_minister	verteidigung_+s_mini_+s_t_+e_r
frau_+en_arzt	frauenarzt
bild_fläche	bildfläche
bio_diesel	biodi_+es_el
schluss_phase	schlus_+s_phase
haus_besitzer	hausb_+es_itz_+e_r
ende_-e_zeit	e_+n_dzei_t
morgen_stunde	morg_+ens_tunde
rechnung_+s_legung	rechnungslegu_+n_g
rente_+n_alter	rentenalt_+e_r
bild_größe	bildgröße
spiel_weise	spielwei_+s_e
volk_+s_schule	volk_+s_schule
druck_luft	druckluft
kunde_+n_datum	kundendatu_m
million_+en_höhe	million_+en_höhe
rat_schlag	ratschlag
betrieb_+s_vereinbarung	betrieb_+s_v_+er_einbaru_+n_g
justiz_ministerium	ju_+s_tizminist_+er_ium
blume_+n_topf	blum_+en_topf
schrift_zug	schriftzug
bericht_+s_jahr	b_+er_icht_+s_jahr
mauer_fall	mau_+er_fall
blick_richtung	blickrichtu_+n_g
miss_achtung	mi_+s_sachtu_+n_g
sucht_prävention	suchtprav_+=e_ntion
strom_ausfall	stromau_+s_fall
system_haus	sy_+s_temhaus
mensch_+en_leben	m_+en_schenleb_+e_n
wasser_wechsel	wa_+s_serwechs_+e_l
ruf_nummer	rufnumm_+e_r
stadt_tor	stadttor
justiz_minister	ju_+s_tizmini_+s_t_+e_r
schach_spieler	schachspiel_+e_r
kommunikation_+s_mittel	kommunikation_+s_mitt_+e_l
ferien_ort	feri_+en_ort
blut_bad	blutba_d
zeitung_+s_artikel	zeitungsartik_+e_l
besatzung_+s_zone	b_+es_atzung_+s_zo_+n_e
vertrieb_+s_partner	vertriebspartn_+e_r
fach_ausschuss	fachau_+s_schuss
rhein_tal	rheintal
handlung_+s_spielraum	handlungsspielraum
qualität_+s_anspruch	qualität_+s_anspruch
sache_-e_preis	sachpreis
gemeinde_mitglied	gemeindemitgli_+e_d
kosten_faktor	ko_+s_tenfaktor
stadt_verkehr	stadtv_+er_kehr
zeit_verschwendung	zeitv_+er_schwe_+n_du_+n_g
familie_+n_unternehmen	familienunt_+er_nehm_+e_n
schau_fenster	schauf_+ens_t_+e_r
entwicklung_+s_zeit	e_+n_twicklung_+s_z_+e_i_t
vogel_grippe	vogelgrippe
ausbildung_+s_jahr	au_+s_bildung_+s_jahr
handlung_+s_strang	handlungsstra_+n_g
auto_versicherung	autov_+er_sich_+er_u_+n_g
produkt_information	produktinformation
wort_meldung	wortmeldu_+n_g
ende_-e_spurt	endspurt
land_+s_leute	landsleute
rad_stand	rad_+s_ta_+n_d
sitz_bank	sitzba_+n_k
familie_+n_urlaub	familienurlaub
mensch_+en_menge	m_+en_sch_+en_menge
wettbewerb_+s_vorteil	wettbew_+er_bsvorteil
garten_möbel	gart_+en_mob_+=e_l
amt_+s_inhaber	amt_+s_inhab_+e_r
blick_kontakt	blickkontakt
kunde_-e_gebung	kundgebu_+n_g
wasser_bett	wa_+s_s_+er_b_+e_tt
telefon_buch	telefonbuch
meinung_+s_austausch	meinungsau_+s_tau_+s_ch
werk_stoff	werk_+s_tof_f
spiel_aufbau	spielaufbau
sicherheit_+s_behörde	sich_+er_heit_+s_behörde
verbreitung_+s_gebiet	verbreitungsgebi_+e_t
dorf_kirche	dorfkirche
seite_+n_wechsel	seitenwechs_+e_l
vorweihnachts_zeit	vorweihnacht_+s_z_+e_i_t
geld_schein	geldschein
sozialversicherung_+s_beitrag	sozialv_+er_sich_+er_ungsbeitrag
wellness_bereich	welln_+es_sb_+er_eich
presse_arbeit	pr_+es_searb_+e_it
bogen_schütze	bog_+ens_chütze
ordnung_+s_widrigkeit	ordnung_+s_widrigkeit
foul_spiel	foulspi_+e_l
markt_anteil	marktanteil
dorf_bewohner	dorfbewohner
gewalt_+en_teilung	g_+e_waltenteilu_+n_g
ziel_linie	ziellinie
medizin_produkt	m_+e_dizinprodukt
pokal_sieger	pokalsieg_+e_r
zeit_spann	zeit_+s_pa_+n_n
hochzeit_+s_feier	hochzeit_+s_fei_+e_r
eingang_+s_bereich	eingang_+s_b_+er_eich
lymphe_-e_knoten	lymphk_+n_ot_+e_n
forschung_+s_feld	for_+s_chung_+s_f_+e_l_d
wind_energie	winden_+er_gie
land_haus	landhaus
meister_leistung	mei_+s_t_+er_lei_+s_tu_+n_g
dampf_lok	dampflok
licht_quelle	lichtquelle
lizenz_gebühr	liz_+en_zgebühr
jugend_bereich	jug_+en_db_+er_eich
weihnacht_+s_geld	weihnacht_+s_g_+e_ld
stand_+=e_rat	stand_+=e_rat
zeit_rahmen	zeitrahm_+e_n
finger_abdruck	fing_+er_abdruck
panik_mache	panikmache
