einsatz_kraft	e_in_+s_a_t_zk_r_a_f_t
linie_+n_bus	l_inie_n_b_u_s
tag_+es_spiegel	t_ag_+es_s_p_i_e_g_e_l
vietnam_krieg	v_ietn_a_m_k_r_i_e_g
finanz_institut	f_in_a_nzin_+s_t_i_t_u_t
bild_+er_galerie	b_il_d_ergal_e_r_i_e
spiel_system	s_p_ie_l_+s_y_+s_t_e_m
bürger_initiative	b_ür_g_er_initia_t_i_v_e
alter_+s_armut	a_lt_er_+s_a_r_m_u_t
kaiser_reich	k_ai_+s_e_r_r_e_i_c_h
weihnacht_+s_fest	w_e_ih_n_acht_+s_f_+es_t
über_leitung	ü_b_erlei_t_u_n_g
bau_maßnahme	b_aumaßn_a_h_m_e
polizei_präsidium	p_o_li_z_e_i_p_r_ä_+s_i_d_i_u_m
bau_grundstück	b_a_u_gr_u_nd_+s_t_ü_c_k
arbeit_+s_unfall	a_rbeit_+s_un_f_a_l_l
projekt_leitung	p_ro_jektlei_t_u_n_g
körper_verletzung	k_ö_r_perverlet_z_u_n_g
industrie_staat	i_n_du_+s_tri_+es_t_a_a_t
reise_land	r_ei_+s_e_l_a_n_d
welt_religion	w_elt_r_e_l_i_g_i_o_n
pflege_familie	p_flegefa_m_i_l_i_e
bachelor_studiengang	b_a_c_h_e_l_or_+s_t_u_di_en_g_a_n_g
haut_farbe	h_autf_a_r_b_e
phi_lippe	p_h_i_l_i_p_p_e
internet_portal	i_ntern_e_t_po_r_t_a_l
fuß_stapfen	f_uß_+s_t_a_p_f_e_n
master_studiengang	m_a_+s_t_er_+s_t_u_di_en_g_a_n_g
alter_+s_grenze	a_lt_e_r_+s_gr_e_n_z_e
beschluss_fassung	b_+es_c_h_l_u_+s_sfa_+s_s_u_n_g
grund_einstellung	g_r_un_de_in_+s_tel_l_u_n_g
über_angebot	ü_ber_ang_e_b_o_t
web_design	w_eb_d_+es_i_g_n
test_ergebnis	t_+es_t_erge_b_n_i_s
tisch_platte	t_i_+s_c_hpl_a_t_t_e
schule_-e_wesen	s_c_h_ul_w_+es_e_n
geburt_+s_hilfe	g_e_burt_+s_h_i_l_f_e
sitz_heizung	s_itz_h_e_i_z_u_n_g
schlag_abtausch	s_chlagabta_u_+s_c_h
hund_+e_rasse	h_un_der_a_+s_s_e
gebiet_+s_körperschaft	g_ebiet_+s_k_ö_r_p_e_r_+s_c_h_a_f_t
putz_frau	p_ut_z_f_r_a_u
leben_+s_gefährtin	l_ebe_n_+s_gef_äh_r_t_i_n
energie_kosten	e_n_e_rgi_e_ko_+s_t_e_n
geo_thermie	g_eot_he_r_m_i_e
bau_leiter	b_aule_i_t_e_r
heim_weg	h_e_i_m_w_e_g
haus_arbeit	h_au_+s_ar_b_e_i_t
presse_freiheit	p_r_+es_s_ef_r_ei_h_e_i_t
kauf_empfehlung	k_auf_e_mpf_e_h_l_u_n_g
ruhe_stand	r_uh_+es_t_a_n_d
motor_sport	m_o_t_o_r_+s_p_o_r_t
frage_+n_katalog	f_ragenkat_a_l_o_g
marke_+n_produkt	m_ark_e_n_p_r_o_d_u_k_t
fund_grube	f_u_n_d_g_r_u_b_e
nutzung_+s_dauer	n_utz_un_g_+s_d_a_u_e_r
unternehmen_+s_beratung	u_nternehme_n_+s_bera_t_u_n_g
klang_farbe	k_l_a_ngf_a_r_b_e
anlauf_punkt	a_nla_u_fp_u_n_k_t
gesetz_+es_entwurf	g_+es_etz_+es_e_nt_w_u_r_f
luft_temperatur	l_uftt_em_per_a_t_u_r
ende_-e_spurt	e_n_d_+s_p_u_r_t
lager_halle	l_agerh_a_l_l_e
hand_schelle	h_a_n_d_+s_c_h_e_l_l_e
stress_situation	s_t_r_+es_s_+s_itua_t_i_o_n
immobilie_+n_markt	i_m_m_o_b_ilienm_a_r_k_t
tod_+es_urteil	t_o_d_+es_ur_t_e_i_l
erz_bistum	e_rz_bi_+s_t_u_m
projekt_tag	p_rojek_t_t_a_g
sonne_+n_untergang	s_onnenunt_er_g_a_n_g
spitze_+n_gruppe	s_pitz_e_n_g_r_u_p_p_e
messe_halle	m_+es_seh_a_l_l_e
buch_händler	b_u_chh_ä_n_d_l_e_r
folge_schaden	f_olg_+es_ch_a_d_e_n
schule_-e_klasse	s_c_h_u_lkl_a_+s_s_e
anforderung_+s_profil	a_n_f_o_r_der_u_n_g_+s_p_r_o_f_i_l
hund_+e_futter	h_undefu_t_t_e_r
sprache_-e_gebrauch	s_p_r_a_chg_ebr_a_u_c_h
kirche_-e_spiel	k_i_r_c_h_+s_p_i_e_l
abfall_wirtschaft	a_b_f_a_l_l_wir_t_+s_c_h_a_f_t
sonder_fall	s_on_d_er_f_a_l_l
verein_+s_geschichte	v_e_re_i_n_+s_g_+es_c_h_i_c_h_t_e
berg_land	b_e_rg_l_a_n_d
zahl_+en_wert	z_ahl_en_w_e_r_t
grund_stein	g_ru_nd_+s_t_e_i_n
öffentlichkeit_+s_arbeit	ö_ffen_t_l_i_chkeit_+s_ar_b_e_i_t
rat_+s_mitglied	r_at_+s_m_it_g_l_i_e_d
schule_-e_sport	s_c_h_u_l_+s_p_o_r_t
straße_+n_seite	s_traßen_+s_e_i_t_e
wirtschaft_+s_forschung	w_ir_t_+s_chaft_+s_f_o_r_+s_c_h_u_n_g
dauer_regen	d_auer_r_e_g_e_n
kaffee_haus	k_affee_h_a_u_s
nord_seite	n_o_rd_+s_e_i_t_e
geburt_+s_tag	g_eburt_+s_t_a_g
rahmen_vertrag	r_ahmenver_t_r_a_g
zeit_geist	z_e_itg_e_i_+s_t
sicherheit_+s_vorkehrung	s_i_c_herheit_+s_v_ork_e_h_r_u_n_g
betreuung_+s_angebot	b_etreu_ung_+s_ang_e_b_o_t
mitbestimmung_+s_recht	m_it_b_+es_timm_u_n_g_+s_r_e_c_h_t
aktion_+s_bündnis	a_k_t_i_o_n_+s_b_ün_d_n_i_s
mitglied_+s_land	m_it_gl_i_e_d_+s_l_a_n_d
datei_name	d_atei_n_a_m_e
stamm_gast	s_ta_mm_g_a_+s_t
kongress_zentrum	k_o_ngr_+es_szen_t_r_u_m
charakter_zug	c_harakt_e_r_z_u_g
information_+s_dienst	i_n_f_orma_t_i_o_+ns_di_e_n_+s_t
schlaf_sack	s_chlaf_+s_a_c_k
kult_status	k_ult_+s_t_a_t_u_s
schule_-e_besuch	s_c_hul_b_+es_u_c_h
anfang_+s_zeit	a_nf_a_n_g_+s_z_e_i_t
wein_gut	w_e_i_n_g_u_t
netz_teil	n_etz_t_e_i_l
kasse_+n_prüfer	k_a_+s_s_e_n_p_r_ü_f_e_r
sport_stätte	s_port_+s_t_ä_t_t_e
blut_spende	b_lu_t_+s_p_e_n_d_e
farbe_-e_ton	f_ar_b_t_o_n
kauf_preis	k_a_u_f_p_r_e_i_s
stau_see	s_ta_u_+s_e_e
härte_fall	h_ärte_f_a_l_l
geld_strafe	g_e_ld_+s_t_r_a_f_e
forst_haus	f_or_+s_t_h_a_u_s
bus_fahrt	b_u_+s_f_a_h_r_t
hose_+n_tasche	h_o_+s_ent_a_+s_c_h_e
unterhaltung_+s_elektronik	u_nterhalt_ung_+s_elek_t_r_o_n_i_k
körper_größe	k_ö_r_p_e_rg_r_ö_ß_e
vertrag_+s_schluss	v_ert_r_a_g_+s_s_c_h_l_u_+s_s
schrift_art	s_c_h_rif_t_a_r_t
hochzeit_+s_tag	h_o_chzeit_+s_t_a_g
wand_malerei	w_a_ndmal_e_r_e_i
über_see	ü_be_r_+s_e_e
zauber_spruch	z_au_b_e_r_+s_p_r_u_c_h
cent_rum	c_en_t_r_u_m
herz_blut	h_e_r_z_b_l_u_t
bund_+es_amt	b_un_d_+es_a_m_t
buch_+=er_regal	b_ü_c_h_er_r_e_g_a_l
arbeit_+s_lohn	a_rbeit_+s_l_o_h_n
verjährung_+s_frist	v_e_rj_ä_hr_u_n_g_+s_f_r_i_+s_t
geschäft_+s_feld	g_+es_c_häft_+s_f_e_l_d
nahrung_+s_ergänzung	n_a_hr_ung_+s_e_rg_ä_n_z_u_n_g
haupt_bahnhof	h_au_ptbah_n_h_o_f
verletzung_+s_gefahr	v_erletz_un_g_+s_ge_f_a_h_r
bau_form	b_a_u_f_o_r_m
über_gabe	ü_b_er_g_a_b_e
arbeit_+s_leben	a_rbeit_+s_l_e_b_e_n
internet_präsenz	i_ntern_e_t_p_rä_+s_e_n_z
datei_größe	d_at_e_ig_r_ö_ß_e
tag_+es_geld	t_ag_+es_g_e_l_d
maus_taste	m_au_+s_t_a_+s_t_e
spur_+en_element	s_purenele_m_e_n_t
geld_menge	g_e_ldm_e_n_g_e
gast_wirtschaft	g_a_+s_t_wir_t_+s_c_h_a_f_t
heim_kino	h_e_im_k_i_n_o
umwelt_bildung	u_m_wel_t_b_i_l_d_u_n_g
regen_zeit	r_egen_z_e_i_t
buch_messe	b_u_chm_+es_s_e
erweiterung_+s_bau	e_r_weiter_ung_+s_b_a_u
stachel_draht	s_t_a_c_h_e_ld_r_a_h_t
haushalt_+s_jahr	h_au_+s_halt_+s_j_a_h_r
versicherung_+s_fall	v_e_r_+s_i_c_her_u_ng_+s_f_a_l_l
sonder_schule	s_o_n_d_e_r_+s_c_h_u_l_e
gast_haus	g_a_+s_t_h_a_u_s
sonder_zug	s_on_d_e_r_z_u_g
platz_mangel	p_latzm_a_n_g_e_l
schild_drüse	s_c_h_i_l_d_d_r_ü_+s_e
folge_tag	f_olg_e_t_a_g
ort_+s_durchfahrt	o_r_t_+s_d_u_r_chf_a_h_r_t
kunst_historiker	k_un_+s_t_hi_+s_t_o_r_i_k_e_r
fachhochschule_-e_reif	f_a_c_h_h_o_c_h_+s_c_h_ul_r_e_i_f
landschaft_+s_park	l_a_n_d_+s_c_haf_t_+s_p_a_r_k
video_spiel	v_i_d_e_o_+s_p_i_e_l
wohnung_+s_bau	w_o_hn_ung_+s_b_a_u
hund_+e_halter	h_undeha_l_t_e_r
nerv_+en_kitzel	n_ervenki_t_z_e_l
schule_-e_träger	s_c_hult_r_ä_g_e_r
bett_decke	b_e_tt_d_e_c_k_e
elber_feld	e_lb_er_f_e_l_d
brand_schutz	b_r_a_n_d_+s_c_h_u_t_z
schule_-e_fest	s_c_hul_f_+es_t
gesundheit_+s_system	g_+es_u_nd_heit_+s_sy_+s_t_e_m
reise_veranstalter	r_ei_+s_everan_+s_ta_l_t_e_r
schloss_garten	s_c_h_l_o_+s_s_ga_r_t_e_n
bestand_+s_kunde	b_+es_ta_n_d_+s_k_u_n_d_e
brief_umschlag	b_r_i_e_f_u_m_+s_c_h_l_a_g
meister_stück	m_ei_+s_t_er_+s_t_ü_c_k
ausstellung_+s_fläche	a_u_+s_st_ell_u_n_g_+s_f_l_ä_c_h_e
atom_anlage	a_toman_l_a_g_e
auto_industrie	a_u_t_o_i_n_du_+s_t_r_i_e
jugend_arbeit	j_ug_en_d_ar_b_e_i_t
tabelle_+n_führer	t_ab_ell_e_n_f_ü_h_r_e_r
bier_garten	b_i_er_ga_r_t_e_n
arbeit_+s_leistung	a_rbeit_+s_l_ei_+s_t_u_n_g
eigentum_+s_wohnung	e_igent_u_m_+s_w_o_h_n_u_n_g
bildung_+s_bereich	b_i_ld_un_g_+s_be_r_e_i_c_h
kreis_gebiet	k_r_e_i_+s_ge_b_i_e_t
traum_frau	t_rau_m_f_r_a_u
stern_stunde	s_tern_+s_t_u_n_d_e
arbeit_+s_vertrag	a_rbeit_+s_ver_t_r_a_g
nacht_ruhe	n_acht_r_u_h_e
team_kollege	t_ea_m_k_ol_l_e_g_e
geburt_+s_ort	g_e_burt_+s_o_r_t
einfluss_faktor	e_i_n_f_l_u_+s_sfa_k_t_o_r
risiko_gruppe	r_i_+s_i_k_o_g_r_u_p_p_e
kartei_karte	k_art_ei_k_a_r_t_e
netto_einkommen	n_ett_oe_i_n_ko_m_m_e_n
krise_+n_situation	k_ri_+s_e_n_+s_itua_t_i_o_n
sekundar_schule	s_ek_un_d_a_r_+s_c_h_u_l_e
teilnehmer_feld	t_e_ilnehm_er_f_e_l_d
ausnahme_genehmigung	a_u_+s_nahmegene_h_m_i_g_u_n_g
europa_meisterschaft	e_u_r_o_pam_ei_+s_t_e_r_+s_c_h_a_f_t
behandlung_+s_methode	b_eh_a_n_dl_ung_+s_me_t_h_o_d_e
land_+es_recht	l_an_d_+es_r_e_c_h_t
internet_auftritt	i_nternetauft_r_i_t_t
regel_werk	r_eg_el_w_e_r_k
stelle_+n_ausschreibung	s_tellen_a_u_+s_s_ch_r_e_i_b_u_n_g
bank_verbindung	b_ankv_e_rb_i_n_d_u_n_g
süd_küste	s_ü_d_k_ü_+s_t_e
bau_träger	b_aut_r_ä_g_e_r
licht_maschine	l_ichtm_a_+s_c_h_i_n_e
person_+en_gesellschaft	p_e_r_+s_on_eng_+es_e_l_l_+s_c_h_a_f_t
organisation_+s_entwicklung	o_rga_ni_+s_a_t_ion_+s_e_n_t_w_i_c_k_l_u_n_g
zauber_wort	z_au_b_e_r_w_o_r_t
gewalt_prävention	g_e_wa_l_t_präven_t_i_o_n
eltern_geld	e_lte_rn_g_e_l_d
natur_gesetz	n_at_urg_+es_e_t_z
fest_veranstaltung	f_+es_tveran_+s_tal_t_u_n_g
bedarf_+s_gemeinschaft	b_e_d_a_r_f_+s_ge_me_i_n_+s_c_h_a_f_t
energie_konzept	e_n_e_rg_i_e_k_on_z_e_p_t
bau_wesen	b_au_w_+es_e_n
flut_licht	f_lut_l_i_c_h_t
fischer_dorf	f_i_+s_c_h_e_r_d_o_r_f
qualität_+s_sicherung	q_ualität_+s_s_i_c_he_r_u_n_g
landwirtschaft_+s_kammer	l_a_n_d_wir_t_+s_chaft_+s_ka_m_m_e_r
herz_stück	h_e_rz_+s_t_ü_c_k
neo_liberalismus	n_e_o_li_bera_l_i_+s_m_u_s
land_kreis	l_a_n_dk_r_e_i_s
wettkampf_tag	w_ettk_a_mp_f_t_a_g
tätigkeit_+s_bereich	t_ä_t_igkeit_+s_be_r_e_i_c_h
grund_fläche	g_r_u_n_df_l_ä_c_h_e
auslauf_modell	a_u_+s_lau_f_m_o_d_e_l_l
internet_nutzer	i_nternetnu_t_z_e_r
flug_gesellschaft	f_l_ugg_+es_e_l_l_+s_c_h_a_f_t
sache_-e_spende	s_a_c_h_+s_p_e_n_d_e
sicherheit_+s_lage	s_i_c_her_heit_+s_l_a_g_e
sicherheit_+s_konzept	s_i_c_her_heit_+s_k_on_z_e_p_t
winter_schlaf	w_int_e_r_+s_c_h_l_a_f
land_+es_behörde	l_an_d_+es_b_e_h_ö_r_d_e
arbeit_+s_umfeld	a_rbeit_+s_um_f_e_l_d
finanz_ausschuss	f_inanz_a_u_+s_s_c_h_u_+s_s
strom_preis	s_t_r_o_m_p_r_e_i_s
post_weg	p_o_+s_t_w_e_g
verfassung_+s_schutz	v_erfa_+s_s_u_n_g_+s_s_c_h_u_t_z
herz_erkrankung	h_erze_rkra_n_k_u_n_g
rettung_+s_paket	r_ett_u_n_g_+s_p_a_k_e_t
kohle_+n_hydrat	k_ohle_n_h_y_d_r_a_t
gesicht_+s_ausdruck	g_+es_icht_+s_a_u_+s_d_r_u_c_k
kur_haus	k_ur_h_a_u_s
mehrzweck_halle	m_e_h_r_z_w_e_ckh_a_l_l_e
wahl_möglichkeit	w_a_hl_m_ö_g_l_i_ch_k_e_i_t
trauer_feier	t_rau_erf_e_i_e_r
miss_achtung	m_i_+s_s_ach_t_u_n_g
film_produktion	f_i_l_m_p_r_o_duk_t_i_o_n
holz_bau	h_ol_z_b_a_u
bau_phase	b_a_up_h_a_+s_e
freizeit_park	f_r_eize_it_p_a_r_k
rand_gruppe	r_a_n_d_g_r_u_p_p_e
information_+s_angebot	i_n_f_orma_t_i_on_+s_ang_e_b_o_t
umwelt_organisation	u_m_wel_t_orga_ni_+s_a_t_i_o_n
gruppe_+n_arbeit	g_r_u_ppe_n_ar_b_e_i_t
sand_sack	s_a_nd_+s_a_c_k
größe_+n_ordnung	g_roß_+=e_n_ord_n_u_n_g
qualität_+s_standard	q_ualität_+s_st_an_d_a_r_d
frieden_+s_nobelpreis	f_r_ieden_+s_no_b_e_l_p_r_e_i_s
schach_spiel	s_c_h_a_c_h_+s_p_i_e_l
familie_+n_urlaub	f_a_m_ilie_n_ur_l_a_u_b
plastik_tüte	p_la_+s_tik_t_ü_t_e
mangel_erscheinung	m_ange_l_e_r_+s_c_hei_n_u_n_g
vorreiter_rolle	v_or_reit_e_r_r_o_l_l_e
gemeinde_zentrum	g_e_me_in_dezen_t_r_u_m
verantwortung_+s_bereich	v_eran_t_wort_ung_+s_be_r_e_i_c_h
euro_zone	e_u_r_o_z_o_n_e
grund_buch	g_r_u_n_d_b_u_c_h
fuß_marsch	f_uß_m_a_r_+s_c_h
koch_buch	k_o_c_h_b_u_c_h
schönheit_+s_ideal	s_chön_heit_+s_i_d_e_a_l
sprache_-e_rohr	s_p_r_a_c_h_r_o_h_r
mode_+n_schau	m_o_d_e_n_+s_c_h_a_u
diskussion_+s_beitrag	d_i_+s_k_u_+s_s_i_o_n_+s_bei_t_r_a_g
leistung_+s_bereich	l_ei_+s_t_ung_+s_be_r_e_i_c_h
gedanke_+n_welt	g_ed_ank_en_w_e_l_t
standort_bestimmung	s_ta_n_dortb_+es_tim_m_u_n_g
gast_familie	g_a_+s_tfa_m_i_l_i_e
kind_+er_haus	k_in_der_h_a_u_s
gegenüber_stellung	g_eg_e_nüb_er_+s_tel_l_u_n_g
samstag_nachmittag	s_am_+s_tag_n_a_chmi_t_t_a_g
nord_west	n_o_rd_w_+es_t
leben_+s_abend	l_eben_+s_a_b_e_n_d
partner_organisation	p_artn_e_r_orga_ni_+s_a_t_i_o_n
verhalten_+s_weise	v_erhalt_e_n_+s_w_e_i_+s_e
gast_+=e_zimmer	g_ä_+s_t_e_zi_m_m_e_r
band_scheibe	b_a_n_d_+s_c_h_e_i_b_e
klasse_+n_raum	k_l_a_+s_s_en_r_a_u_m
literatur_wissenschaft	l_iterat_u_r_w_i_+s_s_e_n_+s_c_h_a_f_t
reise_zeit	r_ei_+s_e_z_e_i_t
bio_diesel	b_i_o_di_+es_e_l
atem_not	a_te_m_n_o_t
zuschauer_zahl	z_u_+s_chau_er_z_a_h_l
grund_nahrungsmittel	g_r_undn_a_hr_ung_+s_mi_t_t_e_l
messe_gelände	m_+es_se_gel_ä_n_d_e
segel_boot	s_ege_l_b_o_o_t
info_stand	i_n_fo_+s_t_a_n_d
land_+es_politik	l_a_n_d_+es_p_ol_i_t_i_k
spiel_gerät	s_p_i_elg_e_r_ä_t
air_port	a_i_r_p_o_r_t
qualität_+s_kontrolle	q_ualität_+s_kont_r_o_l_l_e
leitung_+s_wasser	l_eit_u_n_g_+s_wa_+s_s_e_r
job_börse	j_ob_b_ö_r_+s_e
buße_-e_geld	b_uß_g_e_l_d
bild_bearbeitung	b_i_l_dbe_arbei_t_u_n_g
telefon_nummer	t_el_e_fonnu_m_m_e_r
hand_bewegung	h_a_nd_be_w_e_g_u_n_g
arbeit_+s_entgelt	a_rbeit_+s_ent_g_e_l_t
zahlung_+s_verzug	z_a_hl_ung_+s_v_e_r_z_u_g
wasser_pumpe	w_a_+s_s_e_r_p_u_m_p_e
web_designer	w_eb_d_+es_i_g_n_e_r
zeit_abschnitt	z_eit_a_b_+s_c_h_n_i_t_t
flug_ticket	f_lug_t_i_c_k_e_t
körper_gefühl	k_ö_r_p_er_g_e_f_ü_h_l
download_bereich	d_o_w_nl_o_a_d_be_r_e_i_c_h
körper_pflege	k_ö_r_p_e_r_pf_l_e_g_e
personal_politik	p_e_r_+s_on_a_l_p_ol_i_t_i_k
spiel_leiter	s_p_ielle_i_t_e_r
verkehr_+s_verbund	v_erk_e_hr_+s_v_e_r_b_u_n_d
raum_klima	r_a_u_m_k_l_i_m_a
tür_steher	t_ür_+s_t_e_h_e_r
bau_haus	b_au_h_a_u_s
bundesliga_spiel	b_u_n_d_+es_l_ig_a_+s_p_i_e_l
fehler_meldung	f_ehlerm_e_l_d_u_n_g
persönlichkeit_+s_störung	p_e_r_+s_ö_n_l_i_chkeit_+s_stö_r_u_n_g
haupt_grund	h_au_p_t_g_r_u_n_d
sound_karte	s_o_u_nd_k_a_r_t_e
gesundheit_+s_reform	g_+es_u_nd_heit_+s_r_e_f_o_r_m
energie_quelle	e_n_e_rgiequ_e_l_l_e
bund_+es_recht	b_un_d_+es_r_e_c_h_t
angst_störung	a_ng_+s_t_+s_tö_r_u_n_g
luft_filter	l_uft_fi_l_t_e_r
glück_+s_fall	g_l_ü_c_k_+s_f_a_l_l
praxis_bezug	p_r_a_x_i_+s_b_e_z_u_g
wissen_+s_gesellschaft	w_i_+s_se_n_+s_g_+es_e_l_l_+s_c_h_a_f_t
klang_qualität	k_l_angqual_i_t_ä_t
ende_-e_effekt	e_n_d_ef_f_e_k_t
verwaltung_+s_vorschrift	v_er_walt_ung_+s_v_o_r_+s_c_h_r_i_f_t
widerruf_+s_recht	w_i_d_e_rr_u_f_+s_r_e_c_h_t
strom_leitung	s_t_r_omlei_t_u_n_g
bau_recht	b_au_r_e_c_h_t
haupt_verhandlung	h_auptverh_a_n_d_l_u_n_g
sport_gerät	s_portg_e_r_ä_t
wasser_qualität	w_a_+s_serqual_i_t_ä_t
erwerb_+s_arbeit	e_r_w_e_rb_+s_ar_b_e_i_t
tier_arzt	t_ier_a_r_z_t
start_seite	s_tart_+s_e_i_t_e
sache_-e_gebiet	s_a_chge_b_i_e_t
haus_eigentümer	h_au_+s_eigent_ü_m_e_r
seite_+n_wechsel	s_eit_en_w_e_c_h_+s_e_l
sitz_bank	s_itz_b_a_n_k
stunde_+n_kilometer	s_t_unde_n_k_ilom_e_t_e_r
tier_art	t_ie_r_a_r_t
kosten_übernahme	k_o_+s_t_e_nü_bern_a_h_m_e
haushalt_+s_hilfe	h_au_+s_halt_+s_h_i_l_f_e
jahr_+es_ende	j_ah_r_+es_e_n_d_e
ort_+s_gruppe	o_rt_+s_g_r_u_p_p_e
entwicklung_+s_stand	e_n_t_w_i_c_kl_ung_+s_s_t_a_n_d
elektro_technik	e_lek_tro_t_e_c_h_n_i_k
beruf_+s_wahl	b_e_ru_f_+s_w_a_h_l
ingenieur_wissenschaft	i_ngen_i_e_u_r_w_i_+s_s_e_n_+s_c_h_a_f_t
jugend_verband	j_ugendv_er_b_a_n_d
sack_gasse	s_a_ckg_a_+s_s_e
masse_+n_tourismus	m_a_+s_sent_o_u_r_i_+s_m_u_s
schnee_flocke	s_chn_e_e_f_l_o_c_k_e
leistung_+s_klasse	l_ei_+s_t_u_n_g_+s_kl_a_+s_s_e
gang_art	g_an_g_a_r_t
produktion_+s_prozess	p_r_o_duk_t_i_o_+ns_p_ro_z_+es_s
post_amt	p_o_+s_t_a_m_t
haken_kreuz	h_ake_nk_r_e_u_z
spitze_+n_klasse	s_pitze_nkl_a_+s_s_e
grill_abend	g_r_il_la_b_e_n_d
alltag_+s_leben	a_lltag_+s_l_e_b_e_n
polizei_direktion	p_o_l_i_z_e_i_di_rek_t_i_o_n
fach_gruppe	f_a_c_h_g_r_u_p_p_e
sprache_-e_schule	s_p_r_a_c_h_+s_c_h_u_l_e
haft_pflicht	h_a_f_t_p_f_l_i_c_h_t
natur_freund	n_at_u_rfr_e_u_n_d
aktion_+s_tag	a_k_ti_on_+s_t_a_g
krampf_ader	k_r_a_mpf_a_d_e_r
erde_-e_erwärmung	e_r_d_er_wär_m_u_n_g
posaune_+n_chor	p_o_+s_aun_e_n_c_h_o_r
bildung_+s_wesen	b_i_ld_u_n_g_+s_w_+es_e_n
dienst_zeit	d_ien_+s_t_z_e_i_t
staat_+s_form	s_taat_+s_f_o_r_m
wasser_pflanze	w_a_+s_s_e_r_pfl_a_n_z_e
koalition_+s_partner	k_o_ali_t_i_o_+ns_par_t_n_e_r
foul_elfmeter	f_oulelfm_e_t_e_r
leben_+s_partnerschaft	l_eb_e_+ns_part_n_e_r_+s_c_h_a_f_t
presse_information	p_r_+es_se_i_n_f_orma_t_i_o_n
fach_abteilung	f_ac_habt_ei_l_u_n_g
tanz_musik	t_a_nzm_u_+s_i_k
geschäft_+s_leute	g_+es_c_häft_+s_l_e_u_t_e
front_scheibe	f_ron_t_+s_ch_e_i_b_e
mini_job	m_i_n_i_j_o_b
wohlfahrt_+s_verband	w_o_hlf_ahrt_+s_v_er_b_a_n_d
motor_schaden	m_o_t_o_r_+s_ch_a_d_e_n
funktion_+s_fähigkeit	f_unk_t_i_o_n_+s_f_ä_h_ig_k_e_i_t
einkommen_steuer	e_i_n_kommen_+s_t_e_u_e_r
platte_+n_firma	p_latte_n_f_i_r_m_a
gemeinde_ordnung	g_e_me_i_n_d_e_ord_n_u_n_g
fan_gemeinde	f_ange_me_i_n_d_e
kind_+er_schänder	k_i_n_d_e_r_+s_chä_n_d_e_r
band_breite	b_a_n_db_r_e_i_t_e
mauer_werk	m_au_er_w_e_r_k
schatz_kammer	s_chatzka_m_m_e_r
adresse_-e_buch	a_dr_+es_s_b_u_c_h
pflege_heim	p_flege_h_e_i_m
stück_zahl	s_t_ü_ck_z_a_h_l
sommer_abend	s_omme_ra_b_e_n_d
hersteller_angabe	h_er_+s_teller_an_g_a_b_e
schule_-e_entwicklung	s_c_hule_n_t_w_i_c_k_l_u_n_g
unterricht_+s_stunde	u_nt_e_r_r_icht_+s_st_u_n_d_e
ort_+s_rand	o_rt_+s_r_a_n_d
land_+es_inner	l_an_d_+es_i_n_n_e_r
vertrag_+s_partner	v_ert_ra_g_+s_par_t_n_e_r
straße_+n_beleuchtung	s_traßen_bel_e_uch_t_u_n_g
meinung_+s_äußerung	m_ein_ung_+s_äuße_r_u_n_g
bühne_+n_bild	b_ühn_e_n_b_i_l_d
stadt_geschichte	s_ta_dt_g_+es_c_h_i_c_h_t_e
stunde_+n_plan	s_t_u_nd_e_n_p_l_a_n
gast_+=e_haus	g_ä_+s_te_h_a_u_s
presse_bericht	p_r_+es_se_b_e_r_i_c_h_t
ritter_gut	r_itt_e_r_g_u_t
nachkriegs_zeit	n_a_c_h_k_r_ie_g_+s_z_e_i_t
gesundheit_+s_ministerium	g_+es_u_nd_heit_+s_m_i_ni_+s_t_e_r_i_u_m
arbeit_+s_schwerpunkt	a_rbeit_+s_s_c_h_w_e_rp_u_n_k_t
stunde_+n_satz	s_t_unden_+s_a_t_z
abt_reibung	a_bt_r_e_i_b_u_n_g
haupt_geschäftsführer	h_au_ptg_+es_c_häft_+s_f_ü_h_r_e_r
titel_verteidiger	t_itelvert_e_i_d_i_g_e_r
montag_abend	m_onta_ga_b_e_n_d
kosten_punkt	k_o_+s_t_e_np_u_n_k_t
saison_beginn	s_a_i_+s_on_be_g_i_n_n
vogt_land	v_ogt_l_a_n_d
fußball_verband	f_ußballv_er_b_a_n_d
foul_spiel	f_o_u_l_+s_p_i_e_l
nichts_tun	n_icht_+s_t_u_n
beruf_+s_bildung	b_e_ru_f_+s_b_i_l_d_u_n_g
fach_verband	f_achv_er_b_a_n_d
schluss_folgerung	s_c_h_l_u_+s_s_f_olge_r_u_n_g
ehre_-e_furcht	e_h_r_f_u_r_c_h_t
krieg_+s_schiff	k_r_i_e_g_+s_s_c_h_i_f_f
stadt_bibliothek	s_tad_t_b_i_b_lio_t_h_e_k
forschung_+s_stand	f_o_r_+s_ch_ung_+s_s_t_a_n_d
kraft_training	k_rafttra_i_n_i_n_g
kern_bereich	k_e_rn_be_r_e_i_c_h
stelle_+n_abbau	s_tellen_a_b_b_a_u
schall_welle	s_c_h_a_ll_w_e_l_l_e
kugel_schreiber	k_u_g_e_l_+s_ch_r_e_i_b_e_r
beweis_mittel	b_e_w_e_i_+s_mi_t_t_e_l
welt_ordnung	w_el_t_ord_n_u_n_g
himmel_fahrt	h_imm_elf_a_h_r_t
dauer_karte	d_auer_k_a_r_t_e
natur_heilkunde	n_atur_h_e_i_lk_u_n_d_e
haft_befehl	h_aftbe_f_e_h_l
zusatz_kosten	z_u_+s_at_z_ko_+s_t_e_n
geschmack_sache	g_+es_ch_m_a_ck_+s_a_c_h_e
fußball_mannschaft	f_ußb_allma_n_n_+s_c_h_a_f_t
bau_projekt	b_a_u_p_ro_j_e_k_t
konservierung_+s_stoff	k_on_+s_erv_ier_ung_+s_s_t_o_f_f
verwaltung_+s_gericht	v_er_walt_un_g_+s_g_e_r_i_c_h_t
bund_+es_gericht	b_un_d_+es_g_e_r_i_c_h_t
vernichtung_+s_lager	v_e_r_n_icht_ung_+s_l_a_g_e_r
zahn_+=e_putz	z_äh_n_e_p_u_t_z
fan_club	f_a_n_c_l_u_b
liebe_+s_leben	l_ieb_+es_l_e_b_e_n
anwendung_+s_bereich	a_nwe_nd_un_g_+s_be_r_e_i_c_h
fach_berater	f_a_chber_a_t_e_r
winter_spiel	w_int_e_r_+s_p_i_e_l
verfolgung_+s_jagd	v_e_r_f_o_lg_un_g_+s_j_a_g_d
kunde_+n_bindung	k_und_e_nb_i_n_d_u_n_g
paar_kreuz	p_a_a_rk_r_e_u_z
spiel_klasse	s_p_i_e_lkl_a_+s_s_e
wachstum_+s_markt	w_a_ch_+s_t_um_+s_m_a_r_k_t
fels_brocken	f_e_l_+s_b_r_o_c_k_e_n
rampe_+n_licht	r_a_m_p_e_n_l_i_c_h_t
rast_platz	r_a_+s_tp_l_a_t_z
sicherheit_+s_grund	s_i_c_herheit_+s_g_r_u_n_d
bundestag_+s_fraktion	b_un_d_+es_tag_+s_frak_t_i_o_n
bewerbung_+s_frist	b_e_w_e_rb_u_n_g_+s_f_r_i_+s_t
kirche_+n_leitung	k_i_r_chenlei_t_u_n_g
system_haus	s_y_+s_tem_h_a_u_s
stadt_rat	s_tad_t_r_a_t
ei_+er_stock	e_i_er_+s_t_o_c_k
lymphe_-e_knoten	l_y_m_ph_kn_o_t_e_n
sport_schütze	s_por_t_+s_ch_ü_t_z_e
druck_luft	d_r_u_c_k_l_u_f_t
schloss_park	s_c_h_l_o_+s_s_p_a_r_k
rat_+s_sitzung	r_at_+s_sit_z_u_n_g
höhe_+n_flug	h_öhe_n_f_l_u_g
hafer_flocke	h_a_f_e_r_f_l_o_c_k_e
streit_wert	s_t_re_it_w_e_r_t
auge_+n_höhe	a_ugen_h_ö_h_e
schach_spieler	s_c_h_a_c_h_+s_pi_e_l_e_r
bezirk_+s_liga	b_e_z_i_r_k_+s_l_i_g_a
schüler_zahl	s_c_hü_l_er_z_a_h_l
arbeit_+s_teilung	a_rbeit_+s_t_ei_l_u_n_g
schrift_satz	s_c_h_rift_+s_a_t_z
gesundheit_samt	g_+es_u_ndheit_+s_a_m_t
abend_kasse	a_b_e_ndk_a_+s_s_e
preis_gestaltung	p_r_e_i_+s_g_+es_tal_t_u_n_g
bund_+es_ministerium	b_un_d_+es_m_i_ni_+s_t_e_r_i_u_m
ehe_mann	e_he_m_a_n_n
stadt_+=e_bau	s_tädt_e_b_a_u
geld_institut	g_e_l_din_+s_t_i_t_u_t
fels_wand	f_e_l_+s_w_a_n_d
abend_blatt	a_b_e_n_db_l_a_t_t
mittag_+s_pause	m_itta_g_+s_p_a_u_+s_e
studie_+n_abschluss	s_t_u_die_n_a_b_+s_c_h_l_u_+s_s
spiel_gemeinschaft	s_p_i_elge_me_i_n_+s_c_h_a_f_t
video_überwachung	v_i_d_e_oü_b_er_w_a_c_h_u_n_g
durst_strecke	d_ur_+s_t_+s_t_r_e_c_k_e
sport_bund	s_port_b_u_n_d
grund_struktur	g_r_u_nd_+s_t_ru_k_t_u_r
fall_zahl	f_a_ll_z_a_h_l
streit_fall	s_t_reit_f_a_l_l
mund_winkel	m_u_n_d_w_i_n_k_e_l
energie_beratung	e_n_e_rgiebera_t_u_n_g
blick_fang	b_l_i_ck_f_a_n_g
lizenz_gebühr	l_iz_e_nzg_e_b_ü_h_r
nachwuchs_förderung	n_a_c_h_w_u_c_h_+s_f_ö_r_de_r_u_n_g
feuerwerk_+s_körper	f_eu_er_w_e_r_k_+s_k_ö_r_p_e_r
prüfung_+s_leistung	p_r_üf_u_n_g_+s_l_ei_+s_t_u_n_g
amerika_nische	a_m_e_rik_a_n_i_+s_c_h_e
woche_+n_markt	w_o_chenm_a_r_k_t
feder_bein	f_e_d_er_b_e_i_n
hotel_gast	h_otel_g_a_+s_t
stadt_museum	s_tadtmu_+s_e_u_m
gruppe_+n_leiter	g_r_u_p_penle_i_t_e_r
zahlung_+s_art	z_a_hl_ung_+s_a_r_t
dienstleistung_+s_sektor	d_ien_+s_tl_ei_+s_t_u_ng_+s_se_k_t_o_r
stalin_grad	s_t_al_i_n_g_r_a_d
wasser_dampf	w_a_+s_s_e_rd_a_m_p_f
gesundheit_+s_zustand	g_+es_u_ndheit_+s_zu_+s_t_a_n_d
bau_finanzierung	b_a_ufina_nz_ie_r_u_n_g
ruhe_pause	r_u_hep_a_u_+s_e
schrift_form	s_c_h_rif_t_f_o_r_m
haupt_figur	h_aup_t_f_i_g_u_r
übergang_+s_zeit	ü_b_erg_a_n_g_+s_z_e_i_t
blut_körperchen	b_lut_k_ö_r_p_e_r_c_h_e_n
hafen_stadt	h_afen_+s_t_a_d_t
produktion_+s_mittel	p_r_o_duk_t_i_on_+s_mi_t_t_e_l
krankenhaus_aufenthalt	k_r_ankenhau_+s_aufent_h_a_l_t
innovation_+s_preis	i_nnova_t_i_o_+ns_p_r_e_i_s
job_center	j_o_bce_n_t_e_r
bevölkerung_+s_wachstum	b_ev_ölker_u_n_g_+s_w_a_ch_+s_t_u_m
rauch_entwicklung	r_a_u_che_n_t_w_i_c_k_l_u_n_g
kirche_+n_gemeinde	k_i_r_ch_enge_me_i_n_d_e
gut_+s_hof	g_ut_+s_h_o_f
kommando_zeile	k_omma_n_doz_e_i_l_e
leben_+s_einstellung	l_eb_en_+s_e_in_+s_tel_l_u_n_g
inhalt_+s_stoff	i_n_halt_+s_s_t_o_f_f
konzentration_+s_lager	k_onzentra_t_i_o_n_+s_l_a_g_e_r
kind_+er_geburtstag	k_in_d_ergeburt_+s_t_a_g
not_aufnahme	n_otaufn_a_h_m_e
fußgänger_zone	f_ußg_äng_e_r_z_o_n_e
ausschuss_mitglied	a_u_+s_s_c_h_u_+s_sm_it_g_l_i_e_d
auftrag_+s_eingang	a_uftrag_+s_e_in_g_a_n_g
vertrag_+s_bedingung	v_ertra_g_+s_b_e_d_i_n_g_u_n_g
pacht_vertrag	p_achtver_t_r_a_g
markt_teilnehmer	m_arktt_e_ilne_h_m_e_r
innovation_+s_kraft	i_nnova_t_i_o_n_+s_k_r_a_f_t
evolution_+s_theorie	e_v_olu_t_i_on_+s_t_h_e_o_r_i_e
bank_note	b_an_k_n_o_t_e
turnier_sieg	t_u_rn_i_e_r_+s_i_e_g
acker_fläche	a_ck_e_rf_l_ä_c_h_e
europa_meister	e_u_r_o_pam_ei_+s_t_e_r
leben_+s_versicherung	l_eben_+s_v_e_r_+s_i_c_he_r_u_n_g
natur_erlebnis	n_atur_erle_b_n_i_s
kreuz_weg	k_r_e_u_z_w_e_g
energie_effizienz	e_n_e_rgie_e_f_f_iz_i_e_n_z
mensch_+en_leben	m_e_n_+s_chenl_e_b_e_n
schule_-e_ferien	s_c_h_ulf_e_r_i_e_n
produkt_gruppe	p_r_o_du_k_t_g_r_u_p_p_e
antrag_+s_gegnerin	a_ntra_g_+s_gegn_e_r_i_n
sitz_position	s_i_t_z_p_o_+s_i_t_i_o_n
krebs_erkrankung	k_r_eb_+s_e_rkra_n_k_u_n_g
universität_+s_stadt	u_niv_e_r_+s_ität_+s_s_t_a_d_t
jagd_hund	j_a_g_d_h_u_n_d
strand_promenade	s_tr_a_n_d_p_rome_n_a_d_e
leben_+s_umfeld	l_eben_+s_um_f_e_l_d
politik_wissenschaftler	p_olit_i_k_w_i_+s_s_e_n_+s_chaf_t_l_e_r
münster_land	m_ün_+s_t_er_l_a_n_d
kanzler_amt	k_a_nzle_r_a_m_t
alter_+s_klasse	a_lt_e_r_+s_kl_a_+s_s_e
leben_+s_phase	l_eb_e_+ns_p_h_a_+s_e
quant_+en_mechanik	q_uanten_m_e_ch_a_n_i_k
main_board	m_a_i_nb_o_a_r_d
welt_krieg	w_el_t_k_r_i_e_g
gemeinde_vertreter	g_e_me_indevertr_e_t_e_r
risiko_management	r_i_+s_i_komanage_m_e_n_t
standard_einstellung	s_t_an_d_a_r_de_in_+s_tel_l_u_n_g
auge_+n_arzt	a_ugen_a_r_z_t
dampf_lok	d_a_m_p_f_l_o_k
zeit_verschwendung	z_eitv_e_r_+s_chwe_n_d_u_n_g
lied_text	l_ied_t_e_x_t
grenze_-e_region	g_r_e_nz_re_g_i_o_n
jahr_+es_frist	j_ah_r_+es_f_r_i_+s_t
nutzung_+s_bedingung	n_utz_u_n_g_+s_b_e_d_i_n_g_u_n_g
blut_hochdruck	b_lu_t_h_o_c_h_d_r_u_c_k
aufgabe_+n_stellung	a_ufgaben_+s_tel_l_u_n_g
kultusminister_konferenz	k_ult_u_+s_m_i_ni_+s_t_e_r_k_onfe_r_e_n_z
gesundheit_+s_förderung	g_+es_u_nd_heit_+s_f_ö_r_de_r_u_n_g
volk_+s_partei	v_o_l_k_+s_pa_r_t_e_i
test_person	t_+es_t_pe_r_+s_o_n
kammer_musik	k_ammerm_u_+s_i_k
sünde_+n_fall	s_ünden_f_a_l_l
familie_+n_gericht	f_a_m_ili_en_g_e_r_i_c_h_t
geschäft_+s_partner	g_+es_c_häf_t_+s_par_t_n_e_r
strom_kosten	s_t_r_o_m_ko_+s_t_e_n
röntgen_bild	r_öntg_e_n_b_i_l_d
nachricht_+en_dienst	n_a_c_h_r_icht_e_n_di_e_n_+s_t
aufgabe_+n_gebiet	a_ufgab_enge_b_i_e_t
herz_schlag	h_e_r_z_+s_c_h_l_a_g
held_+en_tat	h_elde_n_t_a_t
gürtel_linie	g_ürt_e_ll_i_n_i_e
straße_+n_bau	s_traße_n_b_a_u
arbeit_+s_bereich	a_rbeit_+s_be_r_e_i_c_h
abend_stunde	a_be_nd_+s_t_u_n_d_e
sicherheit_+s_standard	s_i_c_her_heit_+s_st_an_d_a_r_d
wahl_tag	w_ah_l_t_a_g
erfolg_+s_modell	e_r_f_o_lg_+s_m_o_d_e_l_l
kind_+er_schuh	k_i_n_d_e_r_+s_c_h_u_h
steuer_gerät	s_teu_erg_e_r_ä_t
tanne_+n_baum	t_ann_en_b_a_u_m
ei_gelb	e_i_g_e_l_b
markt_halle	m_arkth_a_l_l_e
leben_+s_lage	l_ebe_n_+s_l_a_g_e
auto_versicherung	a_utov_e_r_+s_i_c_he_r_u_n_g
geschäft_+s_jahr	g_+es_c_häft_+s_j_a_h_r
frühstück_+s_buffet	f_r_üh_+s_t_ü_c_k_+s_bu_f_f_e_t
wirtschaft_+s_faktor	w_ir_t_+s_chaft_+s_fa_k_t_o_r
transport_mittel	t_ra_+ns_portmi_t_t_e_l
vorstellung_+s_gespräch	v_or_+s_tell_u_n_g_+s_g_+es_p_r_ä_c_h
bau_ausschuss	b_au_a_u_+s_s_c_h_u_+s_s
polizei_station	p_o_lizei_+s_ta_t_i_o_n
atom_strom	a_t_om_+s_t_r_o_m
erde_-e_ball	e_r_d_b_a_l_l
besatzung_+s_macht	b_+es_atz_u_ng_+s_m_a_c_h_t
winter_semester	w_inter_+s_em_+es_t_e_r
tod_+es_tag	t_o_d_+es_t_a_g
stadt_recht	s_tadt_r_e_c_h_t
rate_+n_kredit	r_at_e_nk_r_e_d_i_t
kraft_fahrzeug	k_raftf_a_hr_z_e_u_g
preis_träger	p_r_ei_+s_t_r_ä_g_e_r
existenz_gründung	e_xi_+s_t_e_n_z_g_r_ü_n_d_u_n_g
flug_zeit	f_l_ug_z_e_i_t
bund_+es_staat	b_un_d_+es_s_t_a_a_t
handwerk_+s_betrieb	h_a_nd_werk_+s_bet_r_i_e_b
sonne_+n_system	s_onnen_+s_y_+s_t_e_m
kind_+er_tag	k_in_de_r_t_a_g
jahr_+es_umsatz	j_ah_r_+es_um_+s_a_t_z
tourismus_verband	t_o_u_ri_+s_mu_+s_v_er_b_a_n_d
bericht_erstatter	b_e_r_ichter_+s_ta_t_t_e_r
wohnung_+s_suche	w_o_hn_u_n_g_+s_s_u_c_h_e
ort_+s_eingang	o_rt_+s_e_in_g_a_n_g
vertrag_+s_partei	v_ert_ra_g_+s_pa_r_t_e_i
schutz_schild	s_chut_z_+s_c_h_i_l_d
macht_kampf	m_achtk_a_m_p_f
action_film	a_c_t_i_o_n_f_i_l_m
kind_+er_arzt	k_in_der_a_r_z_t
fach_gesellschaft	f_a_chg_+es_e_l_l_+s_c_h_a_f_t
rathaus_platz	r_atha_u_+s_p_l_a_t_z
kind_+er_krankheit	k_in_d_e_rkr_ank_h_e_i_t
kultur_hauptstadt	k_ult_urh_aupt_+s_t_a_d_t
not_lösung	n_otlö_+s_u_n_g
steuer_senkung	s_teu_er_+s_e_n_k_u_n_g
bio_masse	b_iom_a_+s_s_e
steuer_befreiung	s_teu_erb_ef_re_i_u_n_g
gemeinde_haus	g_e_me_inde_h_a_u_s
morgen_post	m_org_e_n_p_o_+s_t
tarif_verhandlung	t_a_rifv_erh_a_n_d_l_u_n_g
kontext_menü	k_on_text_m_e_n_ü
blut_entnahme	b_lutentn_a_h_m_e
studie_+n_fach	s_t_u_di_en_f_a_c_h
katastrophe_+n_schutz	k_ata_+s_t_r_o_ph_e_n_+s_c_h_u_t_z
höhe_+n_lage	h_öhen_l_a_g_e
schlauch_boot	s_chl_a_u_c_h_b_o_o_t
gruppe_+n_foto	g_r_u_ppe_n_f_o_t_o
bedarf_+s_fall	b_e_d_a_r_f_+s_f_a_l_l
land_+es_bischof	l_an_d_+es_b_i_+s_c_h_o_f
kraft_+=e_verhältnis	k_räftever_häl_t_n_i_s
krieg_+s_jahr	k_r_ie_g_+s_j_a_h_r
wahl_beteiligung	w_a_hlbet_e_i_l_i_g_u_n_g
rad_tour	r_ad_t_o_u_r
schaden_+s_ersatz	s_c_haden_+s_er_+s_a_t_z
bemessung_+s_grundlage	b_em_+es_s_un_g_+s_gru_nd_l_a_g_e
mail_adresse	m_ai_l_adr_+es_s_e
information_+s_material	i_n_f_orma_t_ion_+s_mat_e_r_i_a_l
umsatz_steuer	u_m_+s_atz_+s_t_e_u_e_r
titel_kampf	t_it_elk_a_m_p_f
regen_wasser	r_eg_enwa_+s_s_e_r
frau_+en_kirche	f_rau_e_n_k_i_r_c_h_e
tasche_+n_tuch	t_a_+s_chen_t_u_c_h
körper_teil	k_ö_r_per_t_e_i_l
bauch_raum	b_a_u_ch_r_a_u_m
gold_stück	g_o_ld_+s_t_ü_c_k
uhr_werk	u_hr_w_e_r_k
reise_ziel	r_ei_+s_e_z_i_e_l
beruf_+s_alltag	b_e_ruf_+s_al_l_t_a_g
schutz_kleidung	s_chu_t_zk_l_e_i_d_u_n_g
glaube_+ns_frage	g_lauben_+s_f_r_a_g_e
leistung_+s_nachweis	l_ei_+s_t_u_ng_+s_n_a_ch_w_e_i_s
visite_+n_karte	v_i_+s_iten_k_a_r_t_e
gedicht_band	g_e_d_icht_b_a_n_d
staat_+s_theater	s_taat_+s_the_a_t_e_r
kampf_geist	k_a_m_pfg_e_i_+s_t
leben_+s_zeichen	l_eb_e_n_+s_z_e_i_c_h_e_n
weihnacht_+s_geschichte	w_e_ih_n_acht_+s_g_+es_c_h_i_c_h_t_e
handwerk_+s_zeug	h_a_nd_we_r_k_+s_z_e_u_g
reparatur_kosten	r_e_paratu_r_ko_+s_t_e_n
meinung_+s_austausch	m_ein_u_ng_+s_au_+s_ta_u_+s_c_h
land_+s_mann	l_a_n_d_+s_m_a_n_n
zahlung_+s_verkehr	z_a_hl_ung_+s_ver_k_e_h_r
spiel_beginn	s_p_i_el_be_g_i_n_n
alarm_anlage	a_larman_l_a_g_e
erz_engel	e_rz_e_n_g_e_l
blick_richtung	b_l_i_c_k_r_ich_t_u_n_g
mensch_+en_würde	m_e_n_+s_ch_e_n_w_ü_r_d_e
urlaub_+s_zeit	u_rla_u_b_+s_z_e_i_t
feier_stunde	f_eier_+s_t_u_n_d_e
spiel_runde	s_p_i_e_lr_u_n_d_e
wald_rand	w_a_ld_r_a_n_d
sonne_+n_schein	s_onn_e_n_+s_c_h_e_i_n
web_server	w_eb_+s_e_r_v_e_r
speicher_platz	s_p_e_i_c_h_e_rp_l_a_t_z
dach_geschoss	d_a_chg_+es_c_h_o_+s_s
kunst_geschichte	k_un_+s_tg_+es_c_h_i_c_h_t_e
mutter_tag	m_utte_r_t_a_g
sport_anlage	s_portan_l_a_g_e
qualität_+s_kriterium	q_ualität_+s_krit_e_r_i_u_m
gesundheit_+s_schutz	g_+es_u_nd_heit_+s_s_c_h_u_t_z
sturm_flut	s_turm_f_l_u_t
wahl_kreis	w_a_h_lk_r_e_i_s
gemeinschaft_+s_schule	g_e_me_i_n_+s_chaft_+s_s_c_h_u_l_e
sicherheit_+s_risiko	s_i_c_her_heit_+s_r_i_+s_i_k_o
leben_+s_gefühl	l_ebe_n_+s_g_e_f_ü_h_l
stand_art	s_tan_d_a_r_t
winter_dienst	w_int_e_r_di_e_n_+s_t
partei_freund	p_art_e_ifr_e_u_n_d
licht_blick	l_ich_t_b_l_i_c_k
deutschland_funk	d_eu_t_+s_chl_a_n_d_f_u_n_k
land_bevölkerung	l_a_ndbev_ölke_r_u_n_g
träger_verein	t_rägerve_r_e_i_n
arbeit_+s_organisation	a_rbeit_+s_orga_ni_+s_a_t_i_o_n
club_haus	c_lub_h_a_u_s
ausstellung_+s_stück	a_u_+s_st_ell_u_n_g_+s_s_t_ü_c_k
bezug_+s_quelle	b_e_zug_+s_qu_e_l_l_e
geschmack_+s_sache	g_+es_ch_m_a_c_k_+s_s_a_c_h_e
qualität_+s_merkmal	q_ualität_+s_mer_k_m_a_l
jugend_gruppe	j_uge_n_d_g_r_u_p_p_e
atem_luft	a_tem_l_u_f_t
erfüllung_+s_gehilfe	e_r_f_üll_u_n_g_+s_g_e_h_i_l_f_e
küche_+n_zeile	k_ü_ch_enz_e_i_l_e
stein_haus	s_tein_h_a_u_s
tag_+es_ausflug	t_ag_+es_au_+s_f_l_u_g
wind_stärke	w_i_nd_+s_t_ä_r_k_e
olympia_sieger	o_l_y_m_pia_+s_i_e_g_e_r
stadt_kern	s_tadt_k_e_r_n
video_clip	v_i_d_e_o_c_l_i_p
regen_schirm	r_eg_e_n_+s_c_h_i_r_m
grund_studium	g_ru_nd_+s_t_u_d_i_u_m
unterlassung_+s_anspruch	u_nt_erla_+s_s_u_ng_+s_a_+ns_p_r_u_c_h
betrieb_+s_rat	b_e_t_ri_e_b_+s_r_a_t
personal_management	p_e_r_+s_onalmanage_m_e_n_t
hotel_zimmer	h_ot_e_l_zi_m_m_e_r
weg_punkt	w_e_gp_u_n_k_t
wort_meldung	w_ortm_e_l_d_u_n_g
vorstand_+s_vorsitzende	v_or_+s_ta_nd_+s_v_o_r_+s_itz_e_n_d_e
staat_+s_archiv	s_taat_+s_a_r_c_h_i_v
schatten_seite	s_chatten_+s_e_i_t_e
finanz_ausgleich	f_inanza_u_+s_g_l_e_i_c_h
medizin_produkt	m_e_d_iz_i_n_p_r_o_d_u_k_t
energie_preis	e_n_e_rg_i_e_p_r_e_i_s
ecke_-e_punkt	e_c_kp_u_n_k_t
ware_+n_test	w_aren_t_+es_t
mutter_sprachler	m_utt_e_r_+s_p_r_a_c_h_l_e_r
ausländer_behörde	a_u_+s_län_d_erb_e_h_ö_r_d_e
kreuz_fahrt	k_r_e_uzf_a_h_r_t
trieb_wagen	t_ri_eb_w_a_g_e_n
geburtstag_+s_feier	g_eburt_+s_tag_+s_f_e_i_e_r
wasser_straße	w_a_+s_ser_+s_t_r_a_ß_e
dia_mond	d_i_a_m_o_n_d
geschäft_+s_reise	g_+es_c_häft_+s_r_e_i_+s_e
kirche_+n_raum	k_i_r_ch_en_r_a_u_m
ort_+s_beirat	o_rt_+s_b_e_i_r_a_t
verkehr_+s_unfall	v_erk_e_hr_+s_un_f_a_l_l
internet_anschluss	i_nternet_a_n_+s_c_h_l_u_+s_s
rede_wendung	r_e_dewe_n_d_u_n_g
strafe_-e_gesetzbuch	s_tr_afg_+es_et_z_b_u_c_h
weiterbildung_+s_maßnahme	w_eit_e_r_b_i_ld_ung_+s_maßn_a_h_m_e
kleid_+er_schrank	k_l_e_i_d_e_r_+s_ch_r_a_n_k
grund_bildung	g_r_u_n_d_b_i_l_d_u_n_g
ausbildung_+s_zeit	a_u_+s_b_i_ld_u_n_g_+s_z_e_i_t
schaden_freude	s_c_hade_nfr_e_u_d_e
grund_problem	g_r_u_n_d_p_r_o_b_l_e_m
park_möglichkeit	p_ark_m_ö_g_l_i_ch_k_e_i_t
laser_strahl	l_a_+s_er_+s_t_r_a_h_l
strand_korb	s_tr_a_n_d_k_o_r_b
ziel_setzung	z_iel_+s_et_z_u_n_g
abend_programm	a_b_e_n_d_p_r_og_r_a_m_m
erde_-e_reich	e_r_d_r_e_i_c_h
verwaltung_+s_kosten	v_er_walt_u_n_g_+s_ko_+s_t_e_n
schüler_zeitung	s_c_hü_l_erzei_t_u_n_g
hausrat_versicherung	h_au_+s_ratv_e_r_+s_i_c_he_r_u_n_g
fußball_spieler	f_uß_b_a_l_l_+s_p_i_e_l_e_r
entwicklung_+s_projekt	e_n_t_w_i_c_kl_u_n_g_+s_p_ro_j_e_k_t
kauf_entscheidung	k_aufen_t_+s_c_h_e_i_d_u_n_g
fahrzeug_führer	f_a_hrz_e_u_g_f_ü_h_r_e_r
macht_übernahme	m_ac_h_tü_bern_a_h_m_e
bau_gewerbe	b_au_gew_e_r_b_e
wetter_dienst	w_ett_e_r_di_e_n_+s_t
sitz_reihe	s_i_tz_r_e_i_h_e
schmerz_grenze	s_chm_e_r_zgr_e_n_z_e
auftakt_veranstaltung	a_uftaktveran_+s_tal_t_u_n_g
dauer_betrieb	d_au_erbet_r_i_e_b
polizei_inspektion	p_o_li_z_e_i_i_n_+s_pek_t_i_o_n
kind_+er_programm	k_i_n_d_e_r_p_r_og_r_a_m_m
bund_+es_gerichtshof	b_un_d_+es_g_e_r_icht_+s_h_o_f
leistung_+s_steigerung	l_ei_+s_t_un_g_+s_st_eige_r_u_n_g
raum_station	r_aum_+s_ta_t_i_o_n
menschenrecht_+s_organisation	m_e_n_+s_ch_en_r_echt_+s_orga_ni_+s_a_t_i_o_n
entscheidung_+s_findung	e_n_t_+s_c_h_e_id_u_n_g_+s_f_i_n_d_u_n_g
mensch_+en_handel	m_e_n_+s_chenha_n_d_e_l
klima_schutz	k_lim_a_+s_c_h_u_t_z
grund_voraussetzung	g_r_und_vorau_+s_set_z_u_n_g
panik_attacke	p_a_nikat_t_a_c_k_e
spiel_zeit	s_p_i_el_z_e_i_t
dampf_bad	d_a_m_p_f_b_a_d
schach_freund	s_c_h_a_c_hfr_e_u_n_d
zeit_geschichte	z_e_it_g_+es_c_h_i_c_h_t_e
tag_+es_geschäft	t_ag_+es_g_+es_c_h_ä_f_t
geschenk_idee	g_+es_ch_e_n_k_i_d_e_e
ingenieur_büro	i_ngeni_e_u_r_b_ü_r_o
geo_datum	g_eod_a_t_u_m
test_sieger	t_+es_t_+s_i_e_g_e_r
eigentum_+s_recht	e_igent_u_m_+s_r_e_c_h_t
natur_wissenschaft	n_at_u_r_w_i_+s_s_e_n_+s_c_h_a_f_t
lauf_schuh	l_au_f_+s_c_h_u_h
betrieb_+s_wirtschaft	b_e_t_r_i_e_b_+s_wir_t_+s_c_h_a_f_t
rechen_zentrum	r_e_chenzen_t_r_u_m
trend_wende	t_r_e_ndw_e_n_d_e
mitglied_staat	m_it_gli_ed_+s_t_a_a_t
strategie_spiel	s_trat_eg_i_+es_p_i_e_l
hilfe_stellung	h_ilf_+es_tel_l_u_n_g
meer_+es_boden	m_ee_r_+es_b_o_d_e_n
gespräch_+s_kreis	g_+es_p_r_ä_c_h_+s_k_r_e_i_s
ort_+s_verband	o_rt_+s_v_er_b_a_n_d
transport_kosten	t_ra_+ns_por_t_ko_+s_t_e_n
betrieb_+s_system	b_e_tri_e_b_+s_sy_+s_t_e_m
kind_+er_spiel	k_i_n_d_e_r_+s_p_i_e_l
verhalten_+s_regel	v_erhalte_n_+s_r_e_g_e_l
gewicht_+s_abnahme	g_e_w_icht_+s_abn_a_h_m_e
beruf_+s_feuerwehr	b_eruf_+s_feu_er_w_e_h_r
alu_folie	a_l_u_f_o_l_i_e
organ_spende	o_rga_+ns_p_e_n_d_e
antrag_+s_tellerin	a_ntrag_+s_t_ell_e_r_i_n
welt_premiere	w_e_l_t_prem_i_e_r_e
funktion_+s_umfang	f_unk_t_i_on_+s_um_f_a_n_g
gewalt_+en_teilung	g_e_waltent_ei_l_u_n_g
teppich_boden	t_e_p_p_i_c_h_b_o_d_e_n
kirche_+n_geschichte	k_i_r_ch_en_g_+es_c_h_i_c_h_t_e
schwelle_+n_land	s_ch_w_ell_en_l_a_n_d
anschluss_treffer	a_n_+s_c_hl_u_+s_st_r_e_f_f_e_r
vorgänger_modell	v_org_än_ge_r_m_o_d_e_l_l
saison_ende	s_a_i_+s_on_e_n_d_e
grundstück_+s_eigentümer	g_r_u_nd_+s_t_ü_ck_+s_eigent_ü_m_e_r
gedanke_+n_austausch	g_edankenau_+s_ta_u_+s_c_h
umwelt_schützer	u_m_wel_t_+s_ch_ü_t_z_e_r
text_stelle	t_ext_+s_t_e_l_l_e
finanz_dienstleistung	f_in_a_n_z_dien_+s_tl_ei_+s_t_u_n_g
ferien_wohnung	f_e_ri_e_n_w_o_h_n_u_n_g
absicht_+s_erklärung	a_b_+s_icht_+s_e_rk_lä_r_u_n_g
dienst_verhältnis	d_ien_+s_tver_häl_t_n_i_s
beschwerde_verfahren	b_+es_c_h_w_e_rdev_erf_a_h_r_e_n
masse_+n_produktion	m_a_+s_s_e_n_p_r_o_duk_t_i_o_n
maß_gabe	m_aß_g_a_b_e
studie_+n_zeit	s_t_u_di_en_z_e_i_t
dienstleistung_+s_unternehmen	d_ien_+s_tl_ei_+s_t_ung_+s_unterne_h_m_e_n
wind_kraft	w_i_n_dk_r_a_f_t
mark_graf	m_a_r_k_g_r_a_f
bauer_+n_verband	b_auernv_er_b_a_n_d
partner_suche	p_art_n_e_r_+s_u_c_h_e
bombe_+n_angriff	b_omben_a_n_g_r_i_f_f
wasser_versorgung	w_a_+s_serv_e_r_+s_o_r_g_u_n_g
see_bad	s_e_e_b_a_d
strafe_-e_anzeige	s_traf_anz_e_i_g_e
rauch_melder	r_a_u_chm_e_l_d_e_r
tier_schutz	t_i_e_r_+s_c_h_u_t_z
beruf_+s_einstieg	b_e_ruf_+s_e_in_+s_t_i_e_g
geld_anlage	g_eldan_l_a_g_e
zeit_zeug	z_eit_z_e_u_g
bild_qualität	b_ildqual_i_t_ä_t
staat_+s_kanzlei	s_taat_+s_k_a_n_z_l_e_i
lok_führer	l_o_k_f_ü_h_r_e_r
masse_+n_mörder	m_a_+s_se_n_m_ö_r_d_e_r
benzin_preis	b_e_nz_i_n_p_r_e_i_s
boden_schatz	b_o_d_e_n_+s_c_h_a_t_z
grund_gedanke	g_r_u_ndged_a_n_k_e
eintritt_+s_preis	e_in_trit_t_+s_p_r_e_i_s
wort_schatz	w_or_t_+s_c_h_a_t_z
vogel_art	v_oge_l_a_r_t
stadt_umbau	s_tadtu_m_b_a_u
spiel_stätte	s_piel_+s_t_ä_t_t_e
wissen_+s_management	w_i_+s_sen_+s_manage_m_e_n_t
bevölkerung_+s_gruppe	b_ev_ölker_un_g_+s_g_r_u_p_p_e
farbe_-e_kombination	f_a_r_b_k_o_mbina_t_i_o_n
system_steuerung	s_y_+s_tem_+s_teue_r_u_n_g
lärm_belästigung	l_ärmbe_lä_+s_t_i_g_u_n_g
