frau_+en_quote	frauenquote
arbeit_+s_lohn	arbeit_+s_lohn
bund_+es_vereinigung	bund_+es_vereinigung
strom_kreis	stromkreis
frau_+en_haus	frauenhaus
beratung_+s_unternehmen	beratung_+s_unternehmen
kreis_vorstand	krei_+s_vor_+s_tand
rücken_mark	rückenmark
schuld_+en_bremse	schuldenbrem_+s_e
partei_programm	parteiprogramm
garten_anlage	gartenanlage
krise_+n_management	kri_+s_enmanagement
konflikt_lösung	konfliktlö_+s_ung
ausgang_+s_basis	au_+s_gang_+s_ba_+s_is
land_+es_sprache	land_+es_sprache
einsatz_möglichkeit	ein_+s_atzmöglichkeit
kind_+es_wohl	kind_+es_wohl
waffe_+n_stillstand	waffen_+s_till_+s_tand
erde_-e_erwärmung	erderwärmung
tag_+es_presse	tag_+es_pr_+es_se
fund_ort	fundort
tanz_gruppe	tanzgruppe
strom_leitung	stromleitung
arbeit_+s_stätte	arbeit_+s_stätte
geld_strafe	geld_+s_trafe
presse_freiheit	pr_+es_sefreiheit
club_haus	clubhaus
viertel_stunde	viertel_+s_tunde
höhe_+n_lage	höhenlage
gesicht_+s_feld	g_+es_icht_+s_feld
haupt_menü	hauptmenü
droge_+n_konsum	drogenkon_+s_um
organisation_+s_team	organi_+s_ation_+s_team
steuer_gerät	steuergerät
umwelt_einfluss	umwelteinflu_+s_s
erfolg_+s_modell	erfolg_+s_modell
konzentration_+s_lager	konzentration_+s_lager
greif_vogel	greifvogel
leben_+s_kraft	leben_+s_kraft
steuer_erklärung	steuererklärung
betrieb_+s_vereinbarung	betrieb_+s_vereinbarung
kaffee_maschine	kaffeema_+s_chine
staat_+s_bürgerschaft	staat_+s_burg_+=er_schaft
gummi_bärchen	gummibärchen
strom_verbrauch	stromverbrauch
verlag_+s_haus	verlag_+s_haus
asyl_bewerber	a_+s_ylbewerber
stimme_-e_abgabe	stimmabgabe
polizei_beamte	polizeibeamte
blüte_+n_blatt	blütenblatt
verwaltung_+s_gerichtshof	verwaltung_+s_gericht_+s_hof
blut_bild	blutbild
auktion_+s_haus	auktion_+s_haus
kind_+er_krippe	kinderkrippe
tier_klinik	tierklinik
konfiguration_+s_datei	konfiguration_+s_datei
rhein_gau	rheingau
welt_sicht	welt_+s_icht
dame_+n_mannschaft	damenmann_+s_chaft
schiff_fahrt	schifffahrt
jugend_zeit	jugendzeit
mangel_erscheinung	mangeler_+s_cheinung
synergie_effekt	synergieeffekt
hund_+e_rasse	hundera_+s_se
haupt_thema	hauptthema
wasser_oberfläche	wa_+s_seroberfläche
bild_datei	bilddatei
jugend_hilfe	jugendhilfe
tag_+es_spiegel	tag_+es_spiegel
tennis_platz	tenni_+s_platz
gast_wirtschaft	ga_+s_twirt_+s_chaft
schluss_punkt	schlus_+s_punkt
spitze_+n_klasse	spitzenkla_+s_se
ausrüstung_+s_gegenstand	au_+s_rü_+s_tung_+s_gegen_+s_tand
treff_punkt	treffpunkt
haupt_problem	hauptproblem
brett_spiel	brett_+s_piel
wald_brand	waldbrand
haupt_studium	haupt_+s_tudium
elektro_technik	elektrotechnik
arbeit_+s_prozess	arbeit_+s_proz_+es_s
leistung_+s_fähigkeit	lei_+s_tung_+s_fähigkeit
lauf_rad	laufrad
wirtschaft_+s_wachstum	wirt_+s_chaft_+s_wach_+s_tum
haupt_attraktion	hauptattraktion
prüfung_+s_ausschuss	prüfungsau_+s_schu_+s_s
europa_rat	europarat
ruhe_phase	ruhepha_+s_e
familie_+n_planung	familienplanung
geburt_+s_datum	geburt_+s_datum
vertrag_+s_partei	vertrag_+s_partei
lizenz_gebühr	lizenzgebühr
arbeit_+s_sicherheit	arbeit_+s_sicherheit
zeit_lupe	zeitlupe
turnier_sieg	turnier_+s_ieg
leben_+s_zeichen	leben_+s_zeichen
fahrrad_tour	fahrradtour
fach_arbeit	facharbeit
wasser_wert	wa_+s_serwert
sozialversicherung_+s_beitrag	sozialver_+s_icherung_+s_beitrag
bildung_+s_angebot	bildung_+s_angebot
hals_schmerz	hal_+s_schmerz
alter_+s_vorsorge	alter_+s_vor_+s_orge
ton_qualität	tonqualität
schwelle_+n_wert	schwellenwert
planung_+s_sicherheit	planung_+s_sicherheit
bund_+es_vorsitzende	bund_+es_vor_+s_itzende
lager_haus	lagerhaus
integration_+s_politik	integration_+s_politik
brief_tasche	briefta_+s_che
atom_ausstieg	atomau_+s_stieg
versicherung_+s_summe	ver_+s_icherung_+s_summe
regierung_+s_präsident	regierung_+s_prä_+s_ident
meinung_+s_bildung	meinung_+s_bildung
kartoffel_salat	kartoffel_+s_alat
redaktion_+s_schluss	redaktion_+s_schlu_+s_s
messe_besucher	m_+es_seb_+es_ucher
strand_korb	strandkorb
flucht_weg	fluchtweg
euro_vision	eurovi_+s_ion
tier_haltung	tierhaltung
benutzer_freundlichkeit	benutzerfreundlichkeit
gut_+=er_zug	gut_+=er_zug
krankheit_+s_verlauf	krankheit_+s_verlauf
vogt_land	vogtland
inhalt_+s_verzeichnis	inhalt_+s_verzeichnis
gewalt_bereitschaft	gewaltbereit_+s_chaft
boden_platte	bodenplatte
post_amt	po_+s_tamt
sicherheit_+s_lücke	sicherheit_+s_lücke
psycho_pharmaka	p_+s_ychopharmaka
spende_+n_geld	spendengeld
kammer_spiel	kammer_+s_piel
sicherung_+s_system	sicherung_+s_sy_+s_tem
blut_hochdruck	bluthochdruck
jahr_+es_zeit	jahr_+es_zeit
gesundheit_+s_karte	g_+es_undheit_+s_karte
flug_gerät	fluggerät
selbstbewusstsein_+s_training	selb_+s_tbewu_+s_st_+s_ein_+s_training
anziehung_+s_punkt	anziehung_+s_punkt
familie_+n_geschichte	familieng_+es_chichte
liebe_+s_paar	lieb_+es_paar
chip_satz	chip_+s_atz
haus_durchsuchung	hau_+s_durch_+s_uchung
muskel_aufbau	mu_+s_kelaufbau
titel_seite	titel_+s_eite
pauke_+n_schlag	pauken_+s_chlag
masse_+n_medium	ma_+s_senmedium
schnitt_menge	schnittmenge
fußball_turnier	fußballturnier
aufwand_+s_entschädigung	aufwand_+s_ent_+s_chädigung
kreis_vorsitzende	krei_+s_vor_+s_itzende
bund_+es_staat	bund_+es_staat
volk_+=er_mord	volk_+=er_mord
gen_technik	gentechnik
verteidigung_+s_ministerium	verteidigung_+s_mini_+s_terium
wasser_bett	wa_+s_serbett
zauber_spruch	zauber_+s_pruch
zug_führer	zugführer
kur_park	kurpark
personal_entwicklung	per_+s_onalentwicklung
anwalt_+s_kosten	anwalt_+s_ko_+s_ten
familie_+n_unternehmen	familienunternehmen
unterhaltung_+s_elektronik	unterhaltung_+s_elektronik
film_festival	filmf_+es_tival
blut_körperchen	blutkorp_+=er_chen
preis_liste	prei_+s_li_+s_te
reiter_hof	reiterhof
bild_+er_galerie	bildergalerie
einrichtung_+s_gegenstand	einrichtung_+s_gegen_+s_tand
bildung_+s_chance	bildung_+s_chance
bau_amt	bauamt
fan_club	fanclub
test_sieger	t_+es_t_+s_ieger
motor_schaden	motor_+s_chaden
lehrer_ausbildung	lehrerau_+s_bildung
blick_fang	blickfang
fach_buch	fachbuch
tod_+es_tag	tod_+es_tag
steuer_senkung	steuer_+s_enkung
ende_-e_spurt	end_+s_purt
computer_spiel	computer_+s_piel
religion_+s_unterricht	religion_+s_unterricht
sommer_semester	sommer_+s_em_+es_ter
not_arzt	notarzt
buch_form	buchform
wirtschaft_+s_raum	wirt_+s_chaft_+s_raum
hochschule_-e_abschluss	hoch_+s_chulab_+s_chlu_+s_s
schutz_recht	schutzrecht
buch_laden	buchladen
grund_fläche	grundfläche
kraft_fahrer	kraftfahrer
sitz_position	sitzpo_+s_ition
tasche_+n_lampe	ta_+s_chenlampe
ziel_einlauf	zieleinlauf
schütze_+n_verein	schutzenv_+=er_ein
sitz_reihe	sitzreihe
span_dauer	spandauer
qualität_+s_kriterium	qualität_+s_kriterium
gast_freundschaft	ga_+s_tfreund_+s_chaft
schaum_stoff	schaum_+s_toff
stamm_tisch	stammti_+s_ch
arbeit_+s_titel	arbeit_+s_titel
hand_griff	handgriff
personal_kosten	per_+s_onalko_+s_ten
reagenz_glas	reagenzglas
bus_linie	bu_+s_linie
film_geschichte	filmg_+es_chichte
kreuz_fahrt	kreuzfahrt
horn_haut	hornhaut
karte_+n_material	kartenmaterial
kreis_liga	krei_+s_liga
beruf_+s_orientierung	beruf_+s_orientierung
chemo_therapie	chemotherapie
amt_+s_sprache	amt_+s_sprache
spiel_stärke	spiel_+s_tärke
bau_ausschuss	bauau_+s_schu_+s_s
ausnahme_genehmigung	au_+s_nahmegenehmigung
arbeit_+s_hilfe	arbeit_+s_hilfe
anfang_+s_jahr	anfang_+s_jahr
vertrag_+s_arzt	vertrag_+s_arzt
internet_portal	internetportal
mitglied_+s_staat	mitglied_+s_staat
haushalt_+s_hilfe	hau_+s_halt_+s_hilfe
ort_+s_rand	ort_+s_rand
zeit_raum	zeitraum
fach_tagung	fachtagung
risiko_gruppe	ri_+s_ikogruppe
weihnacht_+s_geschichte	weihnacht_+s_g_+es_chichte
schlauch_boot	schlauchboot
veranstaltung_+s_kalender	veran_+s_taltung_+s_kalender
bronze_zeit	bronzezeit
verkauf_+s_fläche	verkauf_+s_fläche
erwerb_+s_leben	erwerb_+s_leben
ort_+s_ausgang	ort_+s_au_+s_gang
küche_+n_zeile	küchenzeile
winde_seil	wind_+es_eil
olive_+n_öl	olivenöl
bewerbung_+s_unterlage	bewerbung_+s_unterlage
volk_+s_mund	volk_+s_mund
energie_bilanz	energiebilanz
bau_beginn	baubeginn
kohle_+n_wasserstoff	kohlenwa_+s_ser_+s_toff
acker_land	ackerland
tanz_musik	tanzmu_+s_ik
hunger_streik	hunger_+s_treik
süd_west	südw_+es_t
lebensmittel_industrie	leben_+s_mittelindu_+s_trie
modell_projekt	modellprojekt
kind_+er_haus	kinderhaus
foto_shooting	foto_+s_hooting
tochter_unternehmen	tochterunternehmen
verwendung_+s_zweck	verwendung_+s_zweck
heu_schnupfen	heu_+s_chnupfen
puder_zucker	puderzucker
welt_bank	weltbank
freund_+es_kreis	freund_+es_kreis
atom_kraftwerk	atomkraftwerk
markt_preis	marktpreis
seite_+n_wechsel	seitenwech_+s_el
tisch_decke	ti_+s_chdecke
leben_+s_partnerschaft	leben_+s_partner_+s_chaft
geburt_+s_stunde	geburt_+s_stunde
trauer_feier	trauerfeier
spiel_brett	spielbrett
vertrag_+s_schluss	vertrag_+s_schlu_+s_s
energie_feld	energiefeld
immobilie_+n_fonds	immobilienfonds
eis_hockey	ei_+s_hockey
ausbildung_+s_stelle	au_+s_bildung_+s_stelle
ziel_ort	zielort
arbeit_+s_kreis	arbeit_+s_kreis
weihnacht_+s_fest	weihnacht_+s_f_+es_t
stadt_grenze	stadtgrenze
sommer_ferien	sommerferien
jugend_bereich	jugendbereich
mittel_punkt	mittelpunkt
krieg_+s_verbrecher	krieg_+s_verbrecher
zusatz_leistung	zu_+s_atzlei_+s_tung
ferien_wohnung	ferienwohnung
arzt_+e_kammer	arztekammer
kokos_nuss	koko_+s_nu_+s_s
flug_betrieb	flugbetrieb
bon_hoeffer	bonhoeffer
anwendung_+s_möglichkeit	anwendung_+s_möglichkeit
radio_aktivität	radioaktivität
hand_schlag	hand_+s_chlag
kind_+er_krankheit	kinderkrankheit
zweck_verband	zweckverband
spitze_+n_wert	spitzenwert
spitze_+n_kandidat	spitzenkandidat
prozent_punkt	prozentpunkt
umwelt_technik	umwelttechnik
bedarf_+s_fall	bedarf_+s_fall
tor_schütze	tor_+s_chütze
posaune_+n_chor	po_+s_aunenchor
sache_-e_preis	sachpreis
schluss_folgerung	schlu_+s_sfolgerung
bar_keeper	barkeeper
bahn_strecke	bahn_+s_trecke
erde_-e_gas	erdgas
organisation_+s_struktur	organi_+s_ation_+s_struktur
hand_bewegung	handbewegung
urlaub_+s_land	urlaub_+s_land
leben_+s_gefühl	leben_+s_gefühl
musik_instrument	mu_+s_ikin_+s_trument
hund_+e_schule	hund_+es_chule
sache_-e_kenntnis	sachkenntnis
klasse_+n_zimmer	kla_+s_senzimmer
spur_+en_element	spurenelement
reise_bus	rei_+s_ebus
animation_+s_film	animation_+s_film
stern_bild	sternbild
sprache_-e_reise	sprachrei_+s_e
krieg_+s_verbrechen	krieg_+s_verbrechen
forschung_+s_stelle	for_+s_chung_+s_stelle
stadt_bild	stadtbild
serie_+n_nummer	seriennummer
auge_+n_winkel	augenwinkel
konjunktur_paket	konjunkturpaket
eltern_haus	elternhaus
arbeit_+s_leben	arbeit_+s_leben
fehler_suche	fehler_+s_uche
stern_+en_flotte	sternenflotte
grund_stimmung	grund_+s_timmung
hochzeit_+s_feier	hochzeit_+s_feier
schule_-e_abschluss	schulab_+s_chlu_+s_s
herz_frequenz	herzfrequenz
arbeit_+s_kampf	arbeit_+s_kampf
problem_fall	problemfall
gift_stoff	gift_+s_toff
spiel_ball	spielball
chip_karte	chipkarte
aktion_+s_tag	aktion_+s_tag
pharma_industrie	pharmaindu_+s_trie
arbeiter_bewegung	arbeiterbewegung
studie_+n_gebühr	studiengebühr
wagen_knecht	wagenknecht
weg_gang	weggang
stadt_kirche	stadtkirche
haushalt_+s_jahr	hau_+s_halt_+s_jahr
tür_rahmen	türrahmen
qualität_+s_sicherung	qualität_+s_sicherung
literatur_hinweis	literaturhinweis
produktion_+s_stätte	produktion_+s_stätte
tag_+e_blatt	tageblatt
hilfe_ruf	hilferuf
haushalt_+s_gerät	hau_+s_halt_+s_gerät
geburt_+s_haus	geburt_+s_haus
organisation_+s_form	organi_+s_ation_+s_form
wasser_dampf	wa_+s_serdampf
kopf_ball	kopfball
verkauf_+s_zahl	verkauf_+s_zahl
militär_dienst	militärdien_+s_t
entscheidung_+s_träger	ent_+s_cheidung_+s_träger
wahl_versprechen	wahlver_+s_prechen
mail_box	mailbox
land_tag	landtag
basis_wissen	ba_+s_i_+s_wi_+s_sen
werk_vertrag	werkvertrag
wasser_fall	wa_+s_serfall
familie_+n_feier	familienfeier
einkauf_+s_straße	einkauf_+s_straße
dino_saurier	dino_+s_aurier
wahl_gang	wahlgang
verkehr_+s_teilnehmer	verkehr_+s_teilnehmer
kunde_+n_beziehung	kundenbeziehung
mittel_wert	mittelwert
sekundar_schule	sekundar_+s_chule
erwartung_+s_haltung	erwartung_+s_haltung
kompetenz_zentrum	kompetenzzentrum
leben_+s_hilfe	leben_+s_hilfe
hoffnung_+s_träger	hoffnung_+s_träger
wirtschaft_+s_minister	wirt_+s_chaft_+s_mini_+s_ter
energie_wirtschaft	energiewirt_+s_chaft
präsidentschaft_+s_wahl	prä_+s_ident_+s_chaft_+s_wahl
tod_+es_angst	tod_+es_ang_+s_t
uni_vers	univers
unternehmen_+s_kommunikation	unternehmen_+s_kommunikation
information_+s_verarbeitung	information_+s_verarbeitung
sieg_+es_zug	sieg_+es_zug
euro_sport	euro_+s_port
sicherheit_+s_lage	sicherheit_+s_lage
studie_+n_abschluss	studienab_+s_chlu_+s_s
sicherheit_+s_system	sicherheit_+s_sy_+s_tem
kunde_+n_dienst	kundendien_+s_t
kontrolle_-e_gruppe	kontrollgruppe
geburt_+en_rat	geburtenrat
bund_+es_anwaltschaft	bund_+es_anwalt_+s_chaft
pflege_kraft	pflegekraft
waffe_+n_gewalt	waffengewalt
pflanze_+n_teil	pflanzenteil
gewalt_tat	gewalttat
legislatur_periode	legi_+s_laturperiode
regen_wasser	regenwa_+s_ser
verhalten_+s_änderung	verhalten_+s_and_+=er_ung
bund_+es_zentrale	bund_+es_zentrale
information_+s_quelle	information_+s_quelle
kreuz_weg	kreuzweg
verein_+s_geschichte	verein_+s_g_+es_chichte
finger_spitz	finger_+s_pitz
amt_+s_inhaber	amt_+s_inhaber
katze_+n_klo	katzenklo
wirtschaft_+s_weise	wirt_+s_chaft_+s_wei_+s_e
gesellschaft_+s_spiel	g_+es_ell_+s_chaft_+s_spiel
straße_+n_fest	straßenf_+es_t
partner_suche	partner_+s_uche
frieden_+s_nobelpreis	frieden_+s_nobelpreis
giro_konto	girokonto
atom_strom	atom_+s_trom
vorsteuer_abzug	vor_+s_teuerabzug
krieg_+s_ende	krieg_+s_ende
air_port	airport
kopf_schmerz	kopf_+s_chmerz
steuer_bescheid	steuerb_+es_cheid
ballung_+s_raum	ballung_+s_raum
start_seite	start_+s_eite
gürtel_linie	gürtellinie
vorweihnachts_zeit	vorweihnacht_+s_zeit
ziel_vorstellung	zielvor_+s_tellung
energie_technik	energietechnik
speicher_platz	speicherplatz
haupt_anliegen	hauptanliegen
wahl_beteiligung	wahlbeteiligung
partner_organisation	partnerorgani_+s_ation
punkt_zahl	punktzahl
land_+es_herr	land_+es_herr
fach_lehrer	fachlehrer
tasche_+n_buch	ta_+s_chenbuch
zeuge_+n_aussage	zeugenau_+s_sage
grund_begriff	grundbegriff
studie_+n_leistung	studienlei_+s_tung
versand_handel	ver_+s_andhandel
umwelt_politik	umweltpolitik
gesellschaft_+s_form	g_+es_ell_+s_chaft_+s_form
einzug_+s_gebiet	einzug_+s_gebiet
leistung_+s_empfänger	lei_+s_tung_+s_empfänger
haupt_aufgabe	hauptaufgabe
versicherung_+s_nehmer	ver_+s_icherung_+s_nehmer
gespräch_+s_thema	g_+es_präch_+s_thema
fall_zahl	fallzahl
kraft_+=e_verhältnis	kraftev_+=er_hältnis
brust_warze	bru_+s_twarze
fisch_markt	fi_+s_chmarkt
unternehmen_+s_berater	unternehmen_+s_berater
amt_+s_gericht	amt_+s_gericht
reise_veranstalter	rei_+s_everan_+s_talter
maul_korb	maulkorb
widerruf_+s_recht	widerruf_+s_recht
forscher_team	for_+s_cherteam
erfolg_+s_faktor	erfolg_+s_faktor
strahl_+en_therapie	strahlentherapie
verkehr_+s_anbindung	verkehr_+s_anbindung
winter_garten	wintergarten
energie_wende	energiewende
haupt_ziel	hauptziel
handlung_+s_weise	handlung_+s_wei_+s_e
bezug_+s_quelle	bezug_+s_quelle
plus_punkt	plu_+s_punkt
durchschnitt_+s_wert	durch_+s_chnitt_+s_wert
gast_arbeiter	ga_+s_tarbeiter
fuhre_-e_park	fuhrpark
elektro_fahrzeug	elektrofahrzeug
machbarkeit_+s_studie	machbarkeit_+s_studie
urlaub_+s_ziel	urlaub_+s_ziel
arbeit_+s_tag	arbeit_+s_tag
bereitschaft_+s_dienst	bereit_+s_chaft_+s_dien_+s_t
automobil_hersteller	automobilher_+s_teller
automobil_industrie	automobilindu_+s_trie
haus_wand	hau_+s_wand
bezirk_samt	bezirk_+s_amt
wohnung_+s_suche	wohnung_+s_suche
mail_server	mail_+s_erver
verbesserung_+s_vorschlag	verb_+es_serung_+s_vor_+s_chlag
zuschauer_zahl	zu_+s_chauerzahl
material_kosten	materialko_+s_ten
organisation_+s_entwicklung	organi_+s_ation_+s_entwicklung
bach_blüte	bachblüte
preis_segment	prei_+s_segment
bibel_stelle	bibel_+s_telle
schule_-e_sport	schul_+s_port
personal_rat	per_+s_onalrat
natur_heilkunde	naturheilkunde
jugend_feuerwehr	jugendfeuerwehr
olympia_sieger	olympia_+s_ieger
reich_+s_stadt	reich_+s_stadt
öl_wechsel	ölwech_+s_el
wermut_+s_tropfen	wermut_+s_tropfen
funk_gerät	funkgerät
aufklärung_+s_arbeit	aufklärung_+s_arbeit
grund_regel	grundregel
heim_niederlage	heimniederlage
tor_möglichkeit	tormöglichkeit
eingabe_feld	eingabefeld
information_+s_veranstaltung	information_+s_veran_+s_taltung
schule_-e_gesetz	schulg_+es_etz
kredit_institut	kreditin_+s_titut
weg_beschreibung	wegb_+es_chreibung
spiel_wiese	spielwi_+es_e
partner_land	partnerland
hochschule_-e_lehrer	hoch_+s_chullehrer
entwicklung_+s_möglichkeit	entwicklung_+s_möglichkeit
tanne_+n_baum	tannenbaum
leben_+s_versicherung	leben_+s_ver_+s_icherung
telefon_anschluss	telefonan_+s_chlu_+s_s
verkehr_+s_verbund	verkehr_+s_verbund
anwendung_+s_gebiet	anwendung_+s_gebiet
vortrag_+s_reihe	vortrag_+s_reihe
bauer_+n_hof	bauernhof
kultur_raum	kulturraum
linie_+n_führung	linienführung
wasser_sport	wa_+s_ser_+s_port
trug_schluss	trug_+s_chlu_+s_s
gemeinschaft_+s_raum	gemein_+s_chaft_+s_raum
ruhe_tag	ruhetag
bau_element	bauelement
gesetzgebung_+s_verfahren	g_+es_etzgebung_+s_verfahren
zeit_spann	zeit_+s_pann
april_scherz	april_+s_cherz
gedanke_+n_welt	gedankenwelt
boot_+s_fahrt	boot_+s_fahrt
beruf_+s_verband	beruf_+s_verband
leistung_+s_stand	lei_+s_tung_+s_stand
fach_gruppe	fachgruppe
bau_jahr	baujahr
küche_+n_tisch	küchenti_+s_ch
vorstellung_+s_gespräch	vor_+s_tellung_+s_g_+es_präch
mittel_stufe	mittel_+s_tufe
kritik_punkt	kritikpunkt
wirt_+s_haus	wirt_+s_haus
medizin_studium	medizin_+s_tudium
bund_+es_durchschnitt	bund_+es_durch_+s_chnitt
liebe_+s_leben	lieb_+es_leben
advent_+s_kalender	advent_+s_kalender
schrift_verkehr	schriftverkehr
wahl_periode	wahlperiode
ehe_partner	ehepartner
krebs_zelle	kreb_+s_zelle
schule_-e_amt	schulamt
stoß_stange	stoß_+s_tange
erz_bistum	erzbi_+s_tum
bürger_stiftung	burg_+=er_stiftung
fach_ausschuss	fachau_+s_schu_+s_s
problem_zone	problemzone
fall_studie	fall_+s_tudie
rate_+n_kredit	ratenkredit
preis_trägerin	prei_+s_trag_+=er_in
partei_vorsitzende	parteivor_+s_itzende
fußball_spiel	fußball_+s_piel
verkauf_+s_stelle	verkauf_+s_stelle
inhalt_+s_angabe	inhalt_+s_angabe
luft_blase	luftbla_+s_e
grafik_karte	grafikkarte
fach_stelle	fach_+s_telle
bio_diesel	biodi_+es_el
gemeinde_zentrum	gemeindezentrum
verkauf_+s_preis	verkauf_+s_preis
diskussion_+s_beitrag	di_+s_ku_+s_sion_+s_beitrag
probe_raum	proberaum
markt_teilnehmer	marktteilnehmer
teilnehmer_zahl	teilnehmerzahl
bau_denkmal	baudenkmal
stress_situation	str_+es_s_+s_ituation
wetter_bericht	wetterbericht
sonne_+n_schein	sonnen_+s_chein
finanz_planung	finanzplanung
ball_verlust	ballverlu_+s_t
protest_aktion	prot_+es_taktion
glaube_+ns_richtung	glauben_+s_richtung
kern_geschäft	kerng_+es_chäft
flüchtling_+s_lager	flüchtling_+s_lager
mittag_essen	mittag_+es_sen
studie_+n_ergebnis	studienergebnis
haus_katze	hau_+s_katze
kommunikation_+s_technik	kommunikation_+s_technik
zugriff_+s_recht	zugriff_+s_recht
training_+s_lager	training_+s_lager
seil_bahn	seilbahn
mineral_stoff	mineral_+s_toff
tabelle_+n_führung	tabellenführung
polizei_station	polizei_+s_tation
film_material	filmmaterial
sonder_aktion	sonderaktion
anfang_+s_zeit	anfang_+s_zeit
einkauf_+s_wagen	einkauf_+s_wagen
geld_anlage	geldanlage
kommentar_funktion	kommentarfunktion
staat_+s_minister	staat_+s_mini_+s_ter
bezirk_+s_verband	bezirk_+s_verband
ausländer_behörde	au_+s_land_+=er_behörde
video_film	videofilm
weihnacht_+s_geld	weihnacht_+s_geld
verwaltung_+s_behörde	verwaltung_+s_behörde
berg_bahn	bergbahn
funktion_+s_störung	funktion_+s_störung
pilot_projekt	pilotprojekt
lauf_steg	lauf_+s_teg
spiel_minute	spielminute
fahrer_sitz	fahrer_+s_itz
kultur_zentrum	kulturzentrum
landschaft_+s_bild	land_+s_chaft_+s_bild
bekanntheit_+s_grad	bekanntheit_+s_grad
straße_+n_netz	straßennetz
ehe_gatte	ehegatte
regen_wurm	regenwurm
titel_song	titel_+s_ong
entwicklung_+s_umgebung	entwicklung_+s_umgebung
band_breite	bandbreite
titel_gewinn	titelgewinn
gesetz_entwurf	g_+es_etzentwurf
leben_+s_umfeld	leben_+s_umfeld
satzung_+s_änderung	satzung_+s_and_+=er_ung
leiter_platte	leiterplatte
geld_politik	geldpolitik
nord_west	nordw_+es_t
email_adresse	emailadr_+es_se
foto_apparat	fotoapparat
ende_-e_stand	end_+s_tand
kunst_sammlung	kun_+s_t_+s_ammlung
geschlecht_+s_verkehr	g_+es_chlecht_+s_verkehr
dank_sagung	dank_+s_agung
geld_beutel	geldbeutel
sonne_+n_energie	sonnenenergie
ingenieur_büro	ingenieurbüro
fahrzeug_führer	fahrzeugführer
wasser_werk	wa_+s_serwerk
alter_+s_armut	alter_+s_armut
uhr_macher	uhrmacher
wirtschaft_+s_faktor	wirt_+s_chaft_+s_faktor
land_straße	land_+s_traße
beruf_+s_wahl	beruf_+s_wahl
persönlichkeit_+s_störung	per_+s_önlichkeit_+s_störung
kap_stadt	kap_+s_tadt
tasche_+n_rechner	ta_+s_chenrechner
einfall_+s_reichtum	einfall_+s_reichtum
fenster_scheibe	fen_+s_ter_+s_cheibe
gast_+=e_bewertung	gä_+s_tebewertung
pflege_kasse	pflegeka_+s_se
video_clip	videoclip
vulkan_ausbruch	vulkanau_+s_bruch
meister_stück	mei_+s_ter_+s_tück
beruf_+s_bezeichnung	beruf_+s_bezeichnung
antrag_+s_formular	antrag_+s_formular
betrieb_+s_stätte	betrieb_+s_stätte
datei_system	datei_+s_y_+s_tem
gast_+=e_haus	gä_+s_tehaus
ausbildung_+s_vertrag	au_+s_bildung_+s_vertrag
musik_schule	musik_+s_chule
eltern_abend	elternabend
weihnacht_+s_zeit	weihnacht_+s_zeit
bühne_+n_bild	bühnenbild
dampf_lok	dampflok
faust_regel	fau_+s_tregel
familie_+n_politik	familienpolitik
gebrauch_+s_gegenstand	gebrauch_+s_gegen_+s_tand
blog_eintrag	blogeintrag
herr_+en_mannschaft	herrenmann_+s_chaft
domain_name	domainname
maschine_+n_raum	ma_+s_chinenraum
besatzung_+s_zone	b_+es_atzung_+s_zone
benefiz_konzert	benefizkonzert
wirtschaft_+s_ministerium	wirt_+s_chaft_+s_mini_+s_terium
binde_mittel	bindemittel
tür_steher	tür_+s_teher
grund_gebühr	grundgebühr
spannung_+s_bogen	spannung_+s_bogen
hochschule_-e_studium	hoch_+s_chul_+s_tudium
miss_handlung	mi_+s_shandlung
öl_preis	ölpreis
grund_struktur	grund_+s_truktur
auto_industrie	autoindu_+s_trie
bund_+es_finanzminister	bund_+es_finanzmini_+s_ter
freizeit_park	freizeitpark
leben_+s_monat	leben_+s_monat
leben_+s_aufgabe	leben_+s_aufgabe
transport_kosten	tran_+s_portko_+s_ten
verkehr_+s_weg	verkehr_+s_weg
abgabe_+n_ordnung	abgabenordnung
kunde_+n_kreis	kundenkreis
haupt_sponsor	haupt_+s_pon_+s_or
kenntnis_stand	kenntni_+s_stand
bearbeitung_+s_zeit	bearbeitung_+s_zeit
arbeit_+s_mittel	arbeit_+s_mittel
kern_aufgabe	kernaufgabe
grenze_-e_gebiet	grenzgebiet
alter_+s_struktur	alter_+s_struktur
meinung_+s_verschiedenheit	meinung_+s_ver_+s_chiedenheit
bund_+es_hauptstadt	bund_+es_haupt_+s_tadt
staat_+s_regierung	staat_+s_regierung
symbol_leiste	symbollei_+s_te
wissen_+s_management	wi_+s_sen_+s_management
band_scheibe	band_+s_cheibe
debüt_album	debütalbum
fehler_meldung	fehlermeldung
lymphe_-e_knoten	lymphknoten
staat_+s_archiv	staat_+s_archiv
auto_radio	autoradio
erfüllung_+s_gehilfe	erfüllung_+s_gehilfe
berg_steiger	berg_+s_teiger
probe_zeit	probezeit
bau_meister	baumei_+s_ter
sieger_land	siegerland
nachricht_+en_dienst	nachrichtendien_+s_t
rate_+n_zahlung	ratenzahlung
gipfel_treffen	gipfeltreffen
leben_+s_raum	leben_+s_raum
wachstum_+s_markt	wach_+s_tum_+s_markt
strom_versorger	stromver_+s_orger
gesundheit_+s_politik	g_+es_undheit_+s_politik
gedicht_band	gedichtband
tief_garage	tiefgarage
qualität_+s_entwicklung	qualität_+s_entwicklung
entwicklung_+s_zeit	entwicklung_+s_zeit
as_set	a_+s_set
umwelt_bildung	umweltbildung
energie_bedarf	energiebedarf
tag_+es_zeit	tag_+es_zeit
über_maß	ub_+=er_maß
medizin_produkt	medizinprodukt
glück_+s_gefühl	glück_+s_gefühl
trieb_wagen	triebwagen
gesicht_+s_ausdruck	g_+es_icht_+s_au_+s_druck
teil_aspekt	teila_+s_pekt
leistung_+s_träger	lei_+s_tung_+s_träger
ton_studio	ton_+s_tudio
bezug_+s_person	bezug_+s_per_+s_on
pflege_stelle	pfleg_+es_telle
sprit_verbrauch	spritverbrauch
wirtschaft_+s_leben	wirt_+s_chaft_+s_leben
fach_arzt	facharzt
halle_+n_turnier	hallenturnier
kunde_+n_bindung	kundenbindung
winter_sport	winter_+s_port
geschmack_sache	g_+es_chmack_+s_ache
uni_klinik	uniklinik
deutschland_radio	deut_+s_chlandradio
bundestag_+s_fraktion	bund_+es_tag_+s_fraktion
abend_stunde	abend_+s_tunde
zeit_verschwendung	zeitver_+s_chwendung
wort_schatz	wort_+s_chatz
wirtschaft_+s_zweig	wirt_+s_chaft_+s_zweig
bezirk_+s_regierung	bezirk_+s_regierung
persönlichkeit_+s_recht	per_+s_önlichkeit_+s_recht
sonder_heft	sonderheft
besucher_zahl	b_+es_ucherzahl
sommer_reifen	sommerreifen
blüte_zeit	blütezeit
master_studium	ma_+s_ter_+s_tudium
stamm_gast	stammga_+s_t
unterlassung_+s_anspruch	unterla_+s_sung_+s_an_+s_pruch
abstieg_+s_platz	ab_+s_tieg_+s_platz
jahr_+es_frist	jahr_+es_fri_+s_t
industrie_zweig	indu_+s_triezweig
sonder_schule	sonder_+s_chule
ziel_gerade	zielgerade
nord_schleife	nord_+s_chleife
energie_form	energieform
petition_+s_ausschuss	petitionsau_+s_schu_+s_s
fach_zeitschrift	fachzeit_+s_chrift
gast_+=e_zimmer	gä_+s_tezimmer
geschäft_+s_leitung	g_+es_chäft_+s_leitung
energie_beratung	energieberatung
spiel_plan	spielplan
hülse_+n_frucht	hül_+s_enfrucht
web_auftritt	webauftritt
straße_+n_seite	straßen_+s_eite
zeit_abschnitt	zeitab_+s_chnitt
brand_bekämpfung	brandbekämpfung
bund_+es_republik	bund_+es_republik
arbeit_+s_recht	arbeit_+s_recht
abfall_wirtschaft	abfallwirt_+s_chaft
aktion_+s_woche	aktion_+s_woche
rundfunk_anstalt	rundfunkan_+s_talt
kunst_hochschule	kun_+s_thoch_+s_chule
verletzung_+s_gefahr	verletzung_+s_gefahr
amok_läufer	amokläufer
dauer_brenner	dauerbrenner
natur_gesetz	naturg_+es_etz
haupt_sitz	haupt_+s_itz
alter_+s_stufe	alter_+s_stufe
fußball_verband	fußballverband
öffnung_+s_zeit	öffnung_+s_zeit
problem_lage	problemlage
bürger_haus	burg_+=er_haus
gesundheit_+s_management	g_+es_undheit_+s_management
ansicht_+s_sache	an_+s_icht_+s_sache
euro_zone	eurozone
spiel_ort	spielort
bürger_versammlung	burg_+=er_ver_+s_ammlung
streit_punkt	streitpunkt
kultur_einrichtung	kultureinrichtung
telefon_gespräch	telefong_+es_präch
kreis_stadt	krei_+s_stadt
gold_medaille	goldmedaille
erfolg_+s_aussicht	erfolgsau_+s_sicht
see_fahrt	seefahrt
bio_technologie	biotechnologie
mittag_+s_zeit	mittag_+s_zeit
gesundheit_+s_schutz	g_+es_undheit_+s_schutz
jahr_+es_anfang	jahr_+es_anfang
hotel_anlage	hotelanlage
land_+es_inner	land_+es_inner
bild_unterschrift	bildunter_+s_chrift
familie_+n_zentrum	familienzentrum
meinung_+s_äußerung	meinung_+s_auß_+=er_ung
projekt_arbeit	projektarbeit
einkommen_steuer	einkommen_+s_teuer
sanierung_+s_arbeit	sanierung_+s_arbeit
wunder_mittel	wundermittel
regel_schule	regel_+s_chule
flug_schule	flug_+s_chule
ordnung_+s_widrigkeit	ordnung_+s_widrigkeit
migration_+s_hintergrund	migration_+s_hintergrund
training_+s_programm	training_+s_programm
rettung_+s_dienst	rettung_+s_dien_+s_t
jugend_leiter	jugendleiter
gewicht_+s_verlust	gewicht_+s_verlu_+s_t
terror_anschlag	terroran_+s_chlag
wahl_möglichkeit	wahlmöglichkeit
atem_zug	atemzug
motor_sport	motor_+s_port
umgang_+s_form	umgang_+s_form
art_+en_schutz	arten_+s_chutz
zeit_fenster	zeitfen_+s_ter
preis_verleihung	prei_+s_verleihung
bau_hof	bauhof
morgen_stern	morgen_+s_tern
information_+s_angebot	information_+s_angebot
radio_sender	radio_+s_ender
fach_publikum	fachpublikum
gegenüber_stellung	gegenub_+=er_stellung
arbeit_+s_raum	arbeit_+s_raum
haupt_person	hauptper_+s_on
verhalten_+s_therapie	verhalten_+s_therapie
ort_+s_bürgermeister	ort_+s_burg_+=er_mei_+s_ter
einsatz_zweck	ein_+s_atzzweck
strecke_+n_führung	streckenführung
chef_arzt	chefarzt
note_+n_bank	notenbank
steuer_zahler	steuerzahler
forschung_+s_zentrum	for_+s_chung_+s_zentrum
spitze_+n_leistung	spitzenlei_+s_tung
finanz_dienstleister	finanzdien_+s_tlei_+s_ter
information_+s_freiheit	information_+s_freiheit
verwaltung_+s_rat	verwaltung_+s_rat
bund_+es_gericht	bund_+es_gericht
text_stelle	text_+s_telle
hand_gelenk	handgelenk
stadt_bahn	stadtbahn
kraftstoff_verbrauch	kraft_+s_toffverbrauch
sicherheit_+s_maßnahme	sicherheit_+s_maßnahme
freizeit_gestaltung	freizeitg_+es_taltung
leben_+s_einstellung	leben_+s_ein_+s_tellung
kultur_hauptstadt	kulturhaupt_+s_tadt
spitze_+n_verband	spitzenverband
preis_senkung	prei_+s_senkung
haushalt_+s_führung	hau_+s_halt_+s_führung
markt_anteil	marktanteil
schule_-e_gelände	schulgelände
europa_meisterschaft	europamei_+s_ter_+s_chaft
hafen_stadt	hafen_+s_tadt
ei_gelb	eigelb
beruf_+s_bildung	beruf_+s_bildung
alter_+s_klasse	alter_+s_kla_+s_se
fußball_weltmeisterschaft	fußballweltmei_+s_ter_+s_chaft
sommer_loch	sommerloch
schuld_+en_krise	schuldenkri_+s_e
mund_art	mundart
wasser_versorgung	wa_+s_server_+s_orgung
band_mitglied	bandmitglied
schule_-e_ferien	schulferien
heim_weg	heimweg
darm_krebs	darmkrebs
photo_synthese	photo_+s_ynth_+es_e
grund_zug	grundzug
schönheit_+s_reparatur	schönheit_+s_reparatur
hand_fläche	handfläche
versorgung_+s_sicherheit	ver_+s_orgung_+s_sicherheit
arbeit_+s_einsatz	arbeit_+s_ein_+s_atz
spitze_+n_gruppe	spitzengruppe
gruppe_+n_mitglied	gruppenmitglied
leben_+s_erwartung	leben_+s_erwartung
quant_+en_physik	quantenphy_+s_ik
hose_+n_tasche	ho_+s_enta_+s_che
schmerz_therapie	schmerztherapie
kultur_politik	kulturpolitik
projekt_team	projektteam
energie_ausweis	energieau_+s_weis
schnitt_punkt	schnittpunkt
fest_stellung	f_+es_t_+s_tellung
amerika_nische	amerikani_+s_che
bund_+es_vorstand	bund_+es_vor_+s_tand
ziel_linie	ziellinie
auge_+n_maß	augenmaß
kammer_musik	kammermu_+s_ik
job_börse	jobbör_+s_e
luft_waffe	luftwaffe
haus_nummer	hau_+s_nummer
urlaub_+s_region	urlaub_+s_region
sound_system	sound_+s_y_+s_tem
plastik_tüte	pla_+s_tiktüte
motor_raum	motorraum
finanz_produkt	finanzprodukt
geld_spende	geld_+s_pende
wasser_kocher	wa_+s_serkocher
gesundheit_+s_versorgung	g_+es_undheit_+s_ver_+s_orgung
spiel_zeit	spielzeit
internet_anschluss	internetan_+s_chlu_+s_s
lager_halle	lagerhalle
abt_reibung	abtreibung
tätigkeit_+s_feld	tätigkeit_+s_feld
erfolg_+s_geschichte	erfolg_+s_g_+es_chichte
sonne_+n_creme	sonnencreme
grund_mauer	grundmauer
kontakt_formular	kontaktformular
umgehung_+s_straße	umgehung_+s_straße
stein_haus	steinhaus
leistung_+s_angebot	lei_+s_tung_+s_angebot
studio_album	studioalbum
geschäft_+s_reisende	g_+es_chäft_+s_rei_+s_ende
kommando_zeile	kommandozeile
schatz_suche	schatz_+s_uche
bewerbung_+s_gespräch	bewerbung_+s_g_+es_präch
